aa	Afaraf
aaa	Ghotuo
aab	Alumu-Tesu
aac	Ari
aac-x-siraul	Siraul
aad	Amal
aae	Arbëreshë Albanian
aaf	Aranadan
aag	Ambrak
aah	Abu' Arapesh
aai	Arifama-Miniafia
aak	Ankave
aal	Afaɗə
aan	Anambé
aao	لهجة صحراوية
aap	Pará Arára
aaq	Eastern Abnaki
aas	Aasáx
aat	Arvanitika Albanian
aau	Abau
aaw	Solong
aax	Mandobo Atas
aaz	Amarasi
aaz-x-amarasibarat	Amarasi Barat
ab	аҧсуа бызшәа, аҧсшәа
aba	Abé
abb	Bankon
abc	Ambala Ayta
abd	Manide
abe	Western Abnaki
abf	Abai Sungai
abg	Abaga
abh	Tajiki Arabic
abi	Abidji
abl	Lampung Nyo
abm	Abanyom
abn	Abua
abo	Abon
abp	Abellen Ayta
abq	абаза
abr	Abron
abs	Ambonese Malay
abt	Ambulas
abu	Abure
abv	العربية البحرانية
abw	Pal
abx	Inabaknon
aby	Aneme Wake
abz	Abui
aca	Achagua
acb	Áncá
acd	Gikyode
ace	Achinese
acf	Lesser Antillean French Creole
ach	Acoli
ach-SS-acholi	Acholi
acm	لهجة عراقية
acm-x-baghdadi	لهجة بغدادية
acm-x-lebarabic	Lebanese Arabic
acn	阿昌
acp	Eastern Acipa
acq	لهجة تعزية-عدنية
acr	Achi
act	Achterhoeks
acu	Achuar-Shiwiar
acv	Achumawi
acw	حجازي
acx	لهجة عمانية
acy	Cypriot Arabic
acz	Garme
ada	Adangme
adb	Adabe
add	Dzodinka
ade	Adele
adf	لهجة ظفارية
adg	Andegerebinha
adh	Adhola
adi	Adi
adi-x-adikarna	Adi Karnataka
adi-x-bokar	Bokar
adi-x-libo	Libo
adi-x-ramo	Ramo
adi-x-zadiboli	Zadi Boli
adj	Adioukrou
adl	Galo
adn	Adang
ado	Abu
adq	Adangbe
adr	Adonara
adr-x-waiwerang	Waiwerang
ads	Adamorobe Sign Language
adt	Adnyamathanha
adu	Aduge
adw	Amundava
adx	ཨ་མདོ་སྐད་
ady	Адыгабзэ
ady-x-syriadyghe	Адыгабзэ
adz	Adzera
aeb	Tunisian Arabic
aec	لهجة صعيدية
aed	Argentine Sign Language
aee	Northeast Pashai
aek	Haeke
ael	Ambele
aem	Arem
aen	Armenian Sign Language
aeq	آیر زبان
aer	Eastern Arrernte
aes	Alsea
aeu	阿克
aew	Ambakich
aey	Amele
aey-x-efu	Efu
aey-x-elien	Elien
aey-x-eranu	Eranu
aey-x-haya	Haya
aey-x-huar	Huar
aey-x-jagalaha	Jagahala
aey-x-midwagi	Mid Wagi
aey-x-ohu	Ohu
aez	Aeka
aez-x-sauga	Sauga
af	Afrikaans
afb	خليجي
afd	Andai
afe	Putukwam
afg	Afghan Sign Language
afh	Afrihili
afi	Akrukay
afk	Nanubae
afn	Defaka
afo	Eloyi
afp	Tapei
afs	Afro-Seminole Creole
aft	Afitti
afu	Awutu
afz	Obokuitai
aga	Aguano
agb	Legbo
agc	Agatu
agd	Agarabi
agd-x-agarabibus	Agarabi Bus
agd-x-agarabkain	Agarabi Kainantu
agd-x-agarabyonk	Agarabi Yonki
agd-x-kona	Agarabi Kona
agd-x-name	Agarabi Name
agd-x-namel	Agarabi Namel
age	Angal
agf	Arguni
agg	Angor
agh	Ngelima
agh-x-balema	Balema
agi	Agariya
agj	Argobba
agk	Isarog Agta
agl	Fembe
agm	Angaataha
agn	Agutaynen
ago	Tainae
agq	Aghem
agr	Aguaruna
ags	Esimbi
agt	Central Cagayan Agta
agu	Aguacateco
agv	Remontado Dumagat
agw	Kahua
agx	агъул чӀал
agy	Southern Alta
agz	Mt. Iriga Agta
aha	Ahanta
aha-x-anrendamaa	Anrendamaa
ahb	Axamb
ahg	Qimant
ahh	Aghu
ahi	Tiagbamrin Aizi
ahk	Akha
ahl	Igo
ahm	Mobumrin Aizi
ahn	Àhàn
aho	Ahom
ahp	Aproumu Aizi
ahr	Ahirani
ahs	Ashe
aht	Ahtena
aia	Arosi
aib	艾努语 (China)
aic	Ainbai
aie	Amara
aif	Agi
aig	Antigua and Barbuda English
aig-x-anguilcreol	Anguillan English
aih	锦话
aii	ܐܬܘܪܝܐ
aij	לשניד נשן
aik	Ake
ail	Aimele
aim	Aimol
ain	アイヌ語 (Japan)
aio	Aiton
aip	Burumakok
aiq	آیماقی
air	Airoran
ais	Nataoran Amis
aiw	Aari
aix	Aighon
aiy	Ali
aja	Aja (Sudan)
ajg	Aja (Benin)
ajg-x-adjtalagbe	Adja Talagbe
aji	Ajië
ajn	Andajin
ajp	South Levantine Arabic
ajt	ערבית יהודית-טוניסאי
aju	מרוקאית יהודית
ajz	Amri Karbi
ak	Akan
akb	Batak Angkola
akc	Mpur
akd	Ukpet-Ehom
ake	Akawaio
akf	Akpa
akg	Anakalangu
akh	Angal Heneng
aki	Aiome
akk	Akkadian
akl	Aklanon
ako	Akurio
akp	Siwu
akq	Ak
akr	Araki
aks	Akaselem
akt	Akolet
aku	Ukum
akv	Ашвaлъи мицIи
akw	Akwa
akz	Alabama
ala	Alago
alc	Qawasqar
ald	Alladian
ale	Aleut
alf	Alege
alh	Alawa
ali	Amaimon
ali-x-sagulam	Sagulam
alj	Alangan
alk	Alak
alk-alakatapue	Alak Atapue
alk-x-alakatapue	Alak Atapue
alk-x-alakxekong	Alak Xekong
all	Allar
alm	Amblong
aln	Gheg Albanian
alo	Larike-Wakasihu
alp	Alune
alq	Algonquin
alr	Алюторский
als	Tosk Albanian
alt	Горно-алтайские
alu	'Are'are
alw	Alaba-K’abeena
alx	Amol
aly	Alyawarr
alz	Alur
am	አማርኛ
ama	Amanayé
amb	Ambo
amc	Amahuaca
ame	Yanesha'
amf	Hamer-Banna
amg	Amurdak
ami	Amis
amj	Amdang
amk	Ambai
aml	War-Jaintia
amm	Ama (Papua New Guinea)
amn	Amanab
amn-x-awaimona	Awai Mona
amo	Amo
amp	Alamblak
amq	Amahai
amr	Amarakaeri
ams	奄美大島北部方言
amt	Amto
amu	Guerrero Amuzgo
amv	Ambelau
amw	ܐܪܡܝܬ
amx	Anmatyerre
amy	Ami
an	aragonés
ana	Andaqui
anc	Ngas
and	Ansus
ane	Xârâcùù
anf	Animere
ang	Old English (ca. 450-1100)
anh	Nend
ani	Андийский
anj	Anor
ank	Goemai
anl	Anu-Hkongso Chin
anl-x-khawngtu	Khawng Tu
anm	Anal
ann	Obolo
ano	Andoque
anp	Angika
anq	Jarawa (India)
anr	Andh
ant	Antakarinya
anu	Anuak
anv	Denya
anw	Anaang
anx	Andra-Hus
any	Anyin
any-x-agnibona	Agni Bona
anz	Anem
aoa	Angolar
aob	Abom
aoc	Pemon
aod	Andarum
aoe	Angal Enen
aof	Bragat
aog	Angoram
aoi	Anindilyakwa
aoj	Mufian
aok	Arhö
aol	Alor
aom	Ömie
aon	Bumbita Arapesh
aon-x-woginara	Woginara
aos	Taikat
aot	Atong (India)
aox	Atorada
aoz	Uab Meto
apb	Sa'a
apb-x-ulawa	Ulawa
apc	لهجات شامية
apc-x-druzearabic	Druze Arabic
apd	لهجة سودانية
apd-x-jaali	Ja'ali
ape	Bukiyip
apf	Pahanan Agta
apg	Ampanang
aph	आठपहरिया‎
api	Apiaká
apj	Jicarilla Apache
apk	Kiowa Apache
apl	Lipan Apache
apm	Mescalero-Chiricahua Apache
apn	Apinayé
apo	Ambul
app	Apma
apr	Arop-Lokep
apr-x-bulakarmel	Bula Karmeleve
aps	Arop-Sissano
apt	Apatani
apu	Apurinã
apv	Alapmunte
apw	Western Apache
apx	Aputai
apy	Apalaí
apz	Safeyoka
aqc	Арчинский
aqd	Ampari Dogon
aqg	Arigidi
aqm	Atohwaim
aqn	Northern Alta
aqp	Atakapa
aqr	Arhâ
aqt	Angaité
aqz	Akuntsu
ar	العربية
arb	العربية الفصحى, عربي فصيح
arc	Official Aramaic (700-300 BCE)
ard	Arabana
are	Western Arrarnta
arh	Arhuaco
ari	Arikara
arj	Arapaso
ark	Arikapú
arl	Arabela
arn	Mapudungun
aro	Araona
arp	Arapaho
arq	دزيرية
arr	Karo (Brazil)
ars	اللهجة النجدية
aru	Aruá (Amazonas State)
arv	Arbore
arw	Arawak
arx	Aruá (Rodonia State)
ar-x-dcv	العربية Dominant Culture Variant
ar-xzn	عربی-خوزستان
ary	الدارجة
arz	اللغه المصريه العاميه
as	অসমীয়া
asa	Asu
asb	Assiniboine
asc	Casuarina Coast Asmat
asd	Asas
asd-x-kou	Kou
ase	American Sign Language
ase-x-beninsl	Benin Sign Language
ase-x-burkinasl	Burkina Faso Sign Language
ase-x-camanglosl	Cameroonian Anglophone Sign Language
ase-x-camfrancsl	Cameroonian Francophone Sign Language
ase-x-congolesl	Congolese Sign Language
ase-x-cotedivosl	Cote d'Ivoire Sign Language
ase-x-gabonesesl	Gabonese Sign Language
ase-x-togolesesl	Togolese Sign Language
ase-x-tongansl	Tongan Sign Language
asf	Australian Sign Language
asg	Cishingini
asi	Buruwai
asj	Sari
ask	Ashkun
asl	Asilulu
asl-x-botswanasl	Botswana Sign Language
asl-x-bukavusl	Bukavu Sign Language
asl-x-drcfrnchsl	Congolese French Sign Language
asl-x-liberiansl	Liberian Sign Language
asl-x-nigersl	Nigerien Sign Language
asl-x-senegalsl	Senegal Sign Language
asn	Xingú Asuriní
aso	Dano
asp	لغة الإشارة الجزائر
asq	Austrian Sign Language
asr	Asuri
ass	Ipulo
ast	Asturian
asu	Tocantins Asurini
asv	Asoa
asw	Australian Aborigines Sign Language
asx	Muratayak
asy	Yaosakor Asmat
asz	As
ata	Pele-Ata
atb	载瓦
atc	Atsahuaca
atd	Ata Manobo
atd-x-paquib	Ata Paquibato Manobo
ate	Atemble
atg	Ivbie North-Okpela-Arhe
ati	Attié
atj	Atikamekw
atk	Ati
atl	Mt. Iraya Agta
atm	Ata
atn	زبان آشتیانی
ato	Atong (Cameroon)
atp	Pudtol Atta
atq	Aralle-Tabulahan
atr	Waimiri-Atroari
ats	Gros Ventre
att	Pamplona Atta
atu	Reel
atv	Горно-алтайская
atw	Atsugewi
atx	Arutani
aty	Aneityum
atz	Arta
aua	Asumboa
aub	Alugu
auc	Waorani
aud	Anuta
aug	Aguna
auh	Aushi
aui	Anuki
auj	لغة أوجلية
auk	Heyo
aul	Aulua
aum	Asu (Nigeria)
aun	Molmo One
auo	Auyokawa
aup	Makayam
auq	Anus
aur	Aruek
aut	Austral
auu	Auye
auw	Awyi
auy	Awiyaana
auy-x-abomatasa	Abomatasa
auy-x-arora	Arora
auy-x-ati	Ati
auy-x-kaiwana	Kaiwana
auy-x-moife	Moife
auy-x-tontona	Tontona
auz	Uzbeki Arabic
av	авар мацӀ, магӀарул мацӀ
avb	Avau
avd	Alviri-Vidari
avi	Avikam
avk	Kotava
avl	لهجة بدوية
avn	Avatime
avt	Au
avu	Avokaya
avv	Avá-Canoeiro
awa	Awadhi
awb	Awa (Papua New Guinea)
awc	Cicipu
awe	Awetí
awh	Awbono
awi	Aekyom
awk	Awabakal
awm	Arawum
awn	Awngi
awo	Awak
awr	Awera
aws	South Awyu
awt	Araweté
awu	Central Awyu
awv	Jair Awyu
aww	Awun
awx	Awara
awy	Edera Awyu
axg	Mato Grosso Arára
axk	Yaka (Central African Republic)
axm	Middle Armenian
axx	Xârâgurè
ay	aymar aru
aya	Awar
ayb	Ayizo Gbe
ayc	Southern Aymara
aye	Ayere
ayg	Ginyanga
ayg-x-anyagan	Anyagan
ayh	لهجة حضرمية
ayi	Leyigha
ayk	Akuku
ayl	ليبي
ayn	لهجة صنعانية
ayo	Ayoreo
ayp	لهجة موصلية
ayq	Ayi (Papua New Guinea)
ayr	Central Aymara
ays	Sorsogon Ayta
ayt	Magbukun Ayta
ayu	Ayu
ayz	Mai Brat
az	azərbaycan dili
aza	Azha
azb	South Azerbaijani
azb-x-afshari	Afshari
azb-x-tabrizazer	Tabriz Azeri
azd	Eastern Durango Nahuatl
azg	San Pedro Amuzgos Amuzgo
azj	Azərbaycan dili
azm	Ipalapa Amuzgo
azn	Western Durango Nahuatl
azo	Awing
azt	Faire Atta
azz	Highland Puebla Nahuatl
ba	башҡорт теле
baa	Babatana
bab	Bainouk-Gunyuño
bac	Badui
bae	Baré
baf	Nubaca
bag	Tuki
bah	Bahamas Creole English
baj	Barakai
bal	بلوچی
bam-x-mali	Bambara
ban	Balinese
bao	Waimaha
bap	बान्तवा
bar	Bavarian
bas	Basa (Cameroon)
bau	Bada (Nigeria)
bav	Vengo
baw	Bambili-Bambui
bax	Bamun
bay	Batuley
bba	Baatonum
bbb	Barai
bbc	Batak Toba
bbc-x-asahan	Asahan
bbd	Bau
bbe	Bangba
bbf	Baibai
bbg	Barama
bbh	布甘语
bbi	Barombi
bbj	Ghomálá'
bbj-x-baleng	Negha Pelongtam
bbk	Babanki
bbl	ბაცბური ენა
bbm	Babango
bbn	Uneapa
bbo	Northern Bobo Madaré
bbp	West Central Banda
bbq	Bamali
bbr	Girawa
bbr-x-paisop	Paisop
bbr-x-yagi	Yagi
bbs	Bakpinka
bbt	Mburku
bbu	Kulung (Nigeria)
bbv	Karnai
bbw	Baba
bbx	Bubia
bby	Befang
bbz	Babalia Creole Arabic
bca	白语
bca-x-bei	Bei
bcb	Bainouk-Samik
bcc	بلوچی زبان
bcc-x-makrani	Makrani Balochi
bcd	North Babar
bce	Bamenyam
bcf	Bamu
bcg	Baga Pokur
bch	Bariai
bci	Baoulé
bci-x-ayaou	Ayaou
bci-x-elomoin	Elomoin
bcj	Bardi
bck	Bunaba
bcl	Central Bikol
bcm	Bannoni
bcn	Bali (Nigeria)
bco	Kaluli
bcp	Bali (Democratic Republic of Congo)
bcq	Bench
bcr	Babine
bcs	Kohumono
bct	Bendi
bcu	Awad Bing
bcu-x-biliau	Biliau
bcu-x-galeg	Galeg
bcu-x-swit	Swit
bcu-x-yamai	Yamai
bcv	Shoo-Minda-Nye
bcv-x-bandawa	Bandawa
bcw	Bana
bcy	Bacama
bcz	Bainouk-Gunyaamolo
bda	Bayot
bda-x-aramme	Bayote Aramme
bda-x-elia	Bayote Elia
bdb	Basap
bdb-x-menaburkecil	Menabur Kecil
bdc	Emberá-Baudó
bdd	Bunama
bde	Bade
bdf	Biage
bdg	Bonggi
bdh	Baka (Sudan)
bdi	Burun
bdj	Bai
bdk	Buduq dili
bdl	Bajo
bdm	Buduma
bdn	Baldemu
bdo	Morom
bdp	Bende
bdq	Tiếng Ba Na
bdr	West Coast Bajau
bdr-x-bajausama	Bajau Sama
bds	Burunge
bdt	Bokoto
bdu	Oroko
bdv	Bodo Parja
bdw	Baham
bdx	Budong-Budong
bdy	Bandjalang
bdz	بدیشی زبان
be	беларуская мова
bea	Beaver
beb	Bebele
bec	Iceve-Maci
bed	Bedoanas
bee	Byangsi
bef	Benabena
beg	Belait
beh	Biali
bei	Bekati'
bei-x-bakatikamayo	Dayak Bakati Kamayo
bei-x-dayakdsa	Dayak Dsa
bei-x-dayaklaya	Dayak Laya
bej	Beja
bek	Bebeli
bek-x-morokea	Morokea
bek-x-mosa	Mosa
bem	Bemba (Zambia)
bem-x-ichishinga	Ichishinga
bem-x-kabenmushi	Kabende Mushi
bem-x-ngumbo	Ngumbo
bem-x-unga	Unga
ben-x-musohor	Musohor
ben-x-sadree	Sadree
beo	Beami
bep	Besoa
beq	Beembe
bes	Besme
bet	Guiberoua Béte
beu	Blagar
bev	Daloa Bété
bew	Betawi
bex	Jur Modo
bey	Beli (Papua New Guinea)
bez	Bena (Tanzania)
bfa	Bari
bfb	Pauri Bareli
bfb-x-pauribarel	Pauri Bareli
bfc	北部方言
bfc-x-lama	Lama
bfd	Bafut
bfe	Betaf
bff	Bofi
bfg	Busang Kayan
bfh	Blafe
bfi	British Sign Language
bfj	Bafanji
bfk	Ban Khor Sign Language
bfl	Banda-Ndélé
bfm	Mmen
bfn	Bunak
bfo	Malba Birifor
bfp	Beba
bfq	Badaga
bfr	Bazigar
bfs	南部方言
bfs-x-liuhebai	Liuhe Bai
bft	بلتی
bfu	Gahri
bfw	Bondo
bfx	Bantayanon
bfy	Bagheli
bfz	Mahasu Pahari
bfz-x-baghlian	Baghliani
bg	български език
bga	Gwamhi-Wuri
bgb	Bobongko
bgc	Haryanvi
bgd	Rathwi Bareli
bgd-x-pawari	Pawari
bge	Bauria
bgf	Bangandu
bgg	Bugun
bgi	Giangan
bgj	Bangolan
bgk	Bit
bgl	Bo (Laos)
bgm	Baga Mboteni
bgn	بلوچی زبان
bgo	Baga Koga
bgp	بلوچی زبان
bgq	Bagri
bgr	Bawm Chin
bgr-x-panam	PaNam
bgs	Tagabawa
bgt	Bughotu
bgu	Mbongno
bgv	Warkay-Bipim
bgw	Bhatri
bgx	Balkan Gagauz Turkish
bgy	Benggoi
bgz	Banggai
bha	Bharia
bhb	Bhili
bhb-x-billori	Billori
bhb-x-kotvaliya	Kotvaliya
bhc	Biga
bhd	Bhadrawahi
bhe	Bhaya
bhf	Odiai
bhg	Binandere
bhg-x-begabari	Begabari
bhg-x-tynsdawari	Tynadawari
bhh	בוכרית
bhi	Bhilali
bhj	Bahing
bhl	Bimin
bhm	لغة باثارية
bhn	ܣܘܪܬ
bho	Bhojpuri
bho-x-thethi	Thethi Bhojpuri
bhp	Bima
bhp-x-donggombojo	Donggo Mbojo
bhq	Tukang Besi South
bhr	Bara Malagasy
bhs	Buwal
bht	Bhattiyali
bhu	Bhunjia
bhv	Bahau
bhw	Biak
bhw-x-betew	Betew
bhx	Bhalay
bhy	Bhele
bhy-x-bakombe	Bakombe
bhy-x-bapakombe	Bapakombe
bhz	Bada (Indonesia)
bi	Bislama
bia	Badimaya
bib	Bissa
bic	Bikaru
bid	Bidiyo
bie	Bepour
bif	Biafada
big	Biangai
bij	Vaghat-Ya-Bijim-Legeri
bik	Bikol
bil	Ɓille
bim	Bimoba
bin	Bini
bio	Nai
bip	Bila
biq	Bipi
bir	Bisorio
bit	Berinomo
biu	Biete
biv	Southern Birifor
biw	Kol (Cameroon)
bix	Bijori
biy	Birhor
biz	Baloi
bja	Budza
bjc	Bariji
bje	标敏方言
bjf	לשניד דינן
bjg	Bidyogo
bjh	Bahinemo
bji	Burji
bjj	Kanauji
bjj-x-khadi	Khadi
bjk	Barok
bjk-x-husen	Husen
bjk-x-nebo	Nebo
bjl	Bulu (Papua New Guinea)
bjm	زبان باجلانی
bjn	Banjar
bjn-x-dayakbanjar	Dayak Banjar
bjn-x-hulu	Dayak Lebang Hulu
bjn-x-pulautelo	Dayak Pulau Telo
bjn-x-seidusun	Dayak Sei Dusun
bjo	Mid-Southern Banda
bjp	Fanamaket
bjr	Binumarien
bjs	Bajan
bjt	Balanta-Ganja
bju	Busuu
bjv	Bedjond
bjw	Bakwé
bjx	Banao Itneg
bjx-x-curaju	Curaju
bjx-x-gubang	Gubang
bjz	Baruga
bjz-x-mado	Mado
bka	Kyak
bkc	Baka (Cameroon)
bkd	Binukid
bkd-x-talaandig	Talaandig
bkf	Beeke
bkg	Buraka
bkh	Bakoko
bki	Baki
bkj	Pande
bkk	Brokskat
bkl	Berik
bkm	Kom (Cameroon)
bkn	Bukitan
bkn-x-punanblusu	Punan Blusu
bko	Kwa'
bkp	Boko (Democratic Republic of Congo)
bkq	Bakairí
bkr	Bakumpai
bkr-x-kalahien	Dusun Kalahien
bkr-x-pajuepat	Paju Epat
bks	Northern Sorsoganon
bkt	Boloki
bku	Buhid
bkv	Bekwarra
bkw	Bekwel
bkx	Baikeno
bky	Bokyi
bkz	Bungku
bla	Siksika
blb	Bilua
blc	Bella Coola
bld	Bolango
ble	Balanta-Kentohe
ble-x-balantanaga	Balanta Naga
blf	Buol
blg	Balau
blh	Kuwaa
bli	Bolia
blj	Bolongan
blk	Pa'o Karen
bll	Biloxi
blm	Beli (Sudan)
bln	Southern Catanduanes Bikol
blo	Anii
blp	Blablanga
blq	Baluan-Pam
blr	布朗方言
bls	Balaesang
blt	Tai Dam
blv	Bolo
blw	Balangao
blx	Mag-Indi Ayta
bly	Notre
blz	Balantak
bm	Bamanankan
bma	Lame
bmb	Bembe
bmb-x-kilungwe	Kilungwe
bmb-x-kirhuma	Kirhuma
bmb-x-kivuluga	Kivuluga
bmc	Biem
bmd	Baga Manduri
bme	Limassa
bmf	Bom
bmg	Bamwe
bmh	Kein
bmh-x-bamsos	Bamsos
bmh-x-jaru	Jaru
bmi	Bagirmi
bmj	Bote-Majhi
bmk	Ghayavi
bml	Bomboli
bmm	Northern Betsimisaraka Malagasy
bmm-x-middlebetsi	Middle Betsimisaraka Malagasy
bmo	Bambalang
bmp	Bulgebi
bmq	Bomu
bmr	Muinane
bms	Bilma Kanuri
bmt	标曼土语
bmu	Somba-Siawari
bmv	Bum
bmw	Bomwali
bmx	Baimak
bmz	Baramu
bn	বাংলা
bna	Bonerate
bnb	Bookan
bnb-x-murutangar	Murut Tangara
bnc	Bontok
bnd	Banda (Indonesia)
bne	Bintauna
bnf	Masiwang
bng	Benga
bni	Bobangi
bnj	Eastern Tawbuid
bnk	Bierebo
bnl	Boon
bnm	Batanga
bnm-x-banoho	Banoho
bnm-x-bapuku	Bapuku
bnn	Bunun
bno	Bantoanon
bnp	Bola
bnp-x-garua	Garua
bnp-x-tamalama	Tamalama
bnq	Bantik
bnr	Butmas-Tur
bns	Bundeli
bnu	Bentong
bnv	Bonerif
bnw	Bisis
bnx	Bangubangu
bnx-TZ-bangubangu	Bangubangu
bnx-x-kasenga	Kasenga
bnx-x-mikebwe	Mikebwe
bnx-x-nkuvu	Nkuvu
bnx-x-nonda	Nonda
bny	Bintulu
bnz	Beezen
bo	བོད་ཡིག
boa	Bora
bob	Aweer
boe	Mundabli
bof	Bolon
bog	Malian Sign Language
boh	Boma
boi	Barbareño
boj	Anjam
bok	Bonjo
bol	Bole
bom	Berom
bon	Bine
boo	Tiemacèwè Bozo
bop	Bonkiman
boq	Bogaya
bor	Borôro
bot	Bongo
bou	Bondei
bov	Tuwuli
bow	Rema
box	Buamu
box-x-dedougou	Bwamu de Dedougou
boy	Bodo (Central African Republic)
boz	Tiéyaxo Bozo
bpa	Daakaka
bpd	Banda-Banda
bpg	Bonggo
bph	Ботлихский
bpi	Bagupi
bpj	Binji
bpk	Orowe
bpl	Broome Pearling Lugger Pidgin
bpm	Biyom
bpn	藻敏
bpo	Anasi
bpp	Kaure
bpq	Banda Malay
bpr	Koronadal Blaan
bpr-x-blantokalon	B'laan toh Kalon
bps	Sarangani Blaan
bps-x-blaanfungo	B'laan Fungol
bpu	Bongu
bpu-x-boimbi	Boimbi
bpv	Bian Marind
bpw	Bo (Papua New Guinea)
bpx	Palya Bareli
bpy	Bishnupriya
bpz	Bilba
bpz-x-diu	Diu
bqa	Tchumbuli
bqb	Bagusa
bqc	Boko (Benin)
bqd	Bung
bqg	Bago-Kusuntu
bqh	白马语
bqi	بختیاری
bqi-x-bakhturk	Turkish Bakhtiari
bqj	Bandial
bqk	Banda-Mbrès
bql	Bilakura
bqm	Wumboko
bqn	Bulgarian Sign Language
bqo	Balo
bqp	Busa
bqq	Biritai
bqr	Burusu
bqs	Bosngun
bqt	Bamukumbit
bqu	Boguru
bqv	Koro Wachi
bqw	Buru (Nigeria)
bqx	Baangi
bqy	Bengkala Sign Language
bqz	Bakaka
br	brezhoneg
bra	Braj
brb	Tiếng Brâu
brd	Baraamu
brf	Bera
brg	Baure
brh	براہوئي
bri	Mokpwe
bri-x-bakweri	Bakweri
brj	Bieria
brl	Birwa
brl-ZW-birwa	Birwa
brm	Barambu
brn	Boruca
bro	Brokkat
brp	Barapasi
brq	Breri
brr	Birao
brs	Baras
brt	Bitare
bru	Eastern Bru
brv	Western Bru
brw	Bellari
brx	Bodo (India)
bry	Burui
brz	Bilbil
bs	bosanski jezik
bsa	Abinomn
bsb	Brunei Bisaya
bsc	Bassari
bse	Wushi
bsf	Bauchi
bsg	زبان بشاگردی
bsh	Kati
bsi	Bassossi
bsj	Bangwinji
bsk	بروشسکی زبان
bsm	Busami
bsn	Barasana-Eduria
bso	Buso
bsp	Baga Sitemu
bsq	Bassa
bsr	Bassa-Kontagora
bss	Akoose
bst	Basketo
bsu	Bahonsuai
bsw	Baiso
bsx	Yangkam
bsy	Sabah Bisaya
bta	Bata
btc	Bati (Cameroon)
btd	Batak Dairi
btd-x-boang	Boang
btd-x-pakpak	Kelasan
bte	Gamo-Ningi
btf	Birgit
btg	Gagnoa Bété
bth	Biatah Bidayuh
bth-x-bidayuhpunten	Dayak Bidayuh Punten
bti	Burate
btj	Bacanese Malay
btl	Bhatola
btm	Batak Mandailing
btn	Ratagnon
bto	Rinconada Bikol
btp	Budibud
btq	Batek
btr	Baetora
bts	Batak Simalungun
bts-x-riangkamie	Timur Riangkamie
btt	Bete-Bendi
btu	Batu
btv	بٹیری
btw	Butuanon
btx	Batak Karo
bty	Bobot
btz	Alas
btz-x-kluet	Kluet
bua	Бурятский
bub	Bua
buc	Bushi
bud	Ntcham
bue	Beothuk
buf	Bushoong
bug	Buginese
bug-x-bugisbaruh	Bugis Barruh
bug-x-bugisboneh	Bugis Boneh
bug-x-bugispinra	Bugis Pinran
bug-x-bugisrapan	Bugis Rapan
bug-x-bugissinja	Bugis Sinjai
bug-x-bugsitdrap	Bugis Sitdrap
bug-x-bulukumba	Bugis Bulukumba
bug-x-endrekan	Bugis Endrekan
bug-x-mandar	Bugis Mandar
buh	优诺语
bui	Bongili
buj	Basa-Gurmana
buk	Bugawac
bum	Bulu (Cameroon)
bun	Sherbro
buo	Terei
bup	Busoa
buq	Brem
bus	Bokobaru
but	Bungain
buu	Budu
buv	Bun
buw	Bubi
bux	Boghom
buy	Bullom So
buz	Bukwen
bva	Barein
bvb	Bube
bvc	Baelelea
bvd	Baeggu
bve	Berau Malay
bvf	Boor
bvg	Bonkeng
bvh	Bure
bvi	Belanda Viri
bvj	Baan
bvk	Bukat
bvl	Bolivian Sign Language
bvm	Bamunka
bvn	Buna
bvo	Bolgo
bvp	布芒语
bvq	Birri
bvr	Burarra
bvt	Bati (Indonesia)
bvu	Bukit Malay
bvw	Boga
bvx	Dibole
bvy	Baybayanon
bvz	Bauzi
bwa	Bwatoo
bwb	Namosi-Naitasiri-Serua
bwc	Bwile
bwd	Bwaidoka
bwe	Bwe Karen
bwf	Boselewa
bwg	Barwe
bwi	Baniwa
bwj	Láá Láá Bwamu
bwk	Bauwaki
bwl	Bwela
bwm	Biwat
bwn	唔奈
bwo	Boro (Ethiopia)
bwp	Mandobo Bawah
bwq	Southern Bobo Madaré
bwr	Bura-Pabir
bws	Bomboma
bwt	Bafaw-Balong
bwu	Buli (Ghana)
bww	Bwa
bwx	布努语
bwy	Cwi Bwamu
bwz	Bwisi
bxa	Tairaha
bxb	Belanda Bor
bxc	Molengue
bxd	波拉
bxe	Birale
bxf	Bilur
bxg	Bangala
bxh	Buhutu
bxj	Bayungu
bxk	Bukusu
bxl	Jalkunan
bxm	Mongolia Buriat
bxn	Burduna
bxo	Barikanchi
bxp	Bebil
bxq	Beele
bxr	Бурятский
bxs	Busam
bxu	布里亞特語
bxw	Bankagooma
bxz	Binahari
bya	Batak
byc	Ubaghara
byd	Benyadu'
byd-x-bedineh	Dayak Bedineh
byd-x-dayakdait	Dayak Dait
byd-x-dayakpantu	Dayak Pantu
byd-x-kerabat	Suku Dayak Kerabat
bye	Pouye
byf	Bete
byg	Baygo
byh	भुजेल
byi	Buyu
byj	Bina (Nigeria)
byk	标话
byl	Bayono
byn	Bilin
byo	Biyo
byp	Bumaji
byr	Baruya
bys	Burak
byv	Medumba
byv-x-hohsieuh	Hoh Sieuh
byv-x-mambelema	Mambelema
byw	Belhariya
byx	Qaqet
byz	Banaro
byz-x-iwarame	Iwarame
byz-x-musiamunat	Musiamunat
byz-x-yawera	Yawera
bza	Bandi
bzb	Andio
bzc	Southern Betsimisaraka Malagasy
bzc-x-antemoro	Antemoro
bzd	Bribri
bze	Jenaama Bozo
bzf	Boikin
bzf-x-duo	Duo
bzg	Babuza
bzh	Mapos Buang
bzi	Bisu
bzj	Belize Kriol English
bzk	Nicaragua Creole English
bzl	Boano (Sulawesi)
bzm	Bolondo
bzn	Boano (Maluku)
bzo	Bozaba
bzp	Kemberano
bzq	Buli (Indonesia)
bzr	Biri
bzs	Brazilian Sign Language
bzt	Brithenig
bzu	Burmeso
bzv	Naami
bzw	Basa (Nigeria)
bzx	Kɛlɛngaxo Bozo
bzy	Obanliku
bzz	Evant
ca	català
caa	Chortí
cab	Garifuna
cac	Chuj
cad	Caddo
cae	Lehar
caf	Southern Carrier
cag	Nivaclé
caj	Chané
cak	Kaqchikel
cal	Carolinian
cam	Cemuhî
can	Chambri
cao	Chácobo
cap	Chipaya
caq	Car Nicobarese
car	Galibi Carib
cas	Tsimané
cav	Cavineña
caw	Callawalla
cax	Chiquitano
cay	Cayuga
caz	Canichana
cbb	Cabiyarí
cbc	Carapana
cbd	Carijona
cbg	Chimila
cbi	Chachi
cbj	Ede Cabe
cbk	Chavacano
cbl	Bualkhaw Chin
cbn	Nyahkur
cbo	Izora
cbq	Tsucuba
cbr	Cashibo-Cacataibo
cbs	Cashinahua
cbt	Chayahuita
cbu	Candoshi-Shapra
cbu-x-chapra	Chapra
cbv	Cacua
cbw	Kinabalian
cby	Carabayo
ccc	Chamicuro
ccd	Cafundo Creole
cce	Chopi
ccg	Samba Daka
cch	Atsam
ccj	Kasanga
ccl	Cutchi-Swahili
ccm	Malaccan Creole Malay
cco	Comaltepec Chinantec
ccp	Chakma
cda	Choni
cde	Chenchu
cdf	Chiru
cdg	Chamari
cdh	Chambeali
cdi	Chodri
cdj	Churahi
cdm	Chepang
cdn	Chaudangsi
cdo	闽东语
cdr	Cinda-Regi-Tiyal
cds	Chadian Sign Language
cdy	茶洞語
cdz	Koda
ce	нохчийн мотт
cea	Lower Chehalis
ceb	Cebuano
ceb-x-boholano	Boholano
ceb-x-siquijodnon	Siquijodnon
ceg	Chamacoco
cek	Eastern Khumi Chin
cek-x-asangkhawngso	Asang Khawngso
cek-x-taaw	Ta-Aw Rengcaa
cen	Cen
cet	Centúúm
cfa	Dijim-Bwilim
cfa-x-dijim	Dǝjim
cfd	Cara
cfg	Como Karim
cfm	Falam Chin
cfm-x-chorei	Chorei
cfm-x-kaipeng	Kaipeng
cfm-x-molsom	Molsom
cfm-x-tapong	Tapong
cga	Changriwa
cgc	Kagayanen
cgg	Chiga
cgg-x-rutwa	Rutwa
cgk	Chocangacakha
ch	Chamoru
chb	Chibcha
chc	Catawba
chd	Highland Oaxaca Chontal
chf	Tabasco Chontal
chh	Chinook
chj	Ojitlán Chinantec
chk	Chuukese
chl	Cahuilla
chm	Mari (Russia)
chn	Chinook jargon
cho	Choctaw
chp	Chipewyan
chq	Quiotepec Chinantec
chr	Cherokee
chw	Chuwabu
chx	Chantyal
chy	Cheyenne
chz	Ozumacín Chinantec
cia	Cia-Cia
cib	Ci Gbe
cic	Chickasaw
cie	Cineni
cih	Chinali
cik	Chitkuli Kinnauri
cim	Cimbrian
cin	Cinta Larga
cip	Chiapanec
cir	Tiri
ciw	Chippewa
ciy	Chaima
cja	Tây Chăm
cje	Chru
cjh	Upper Chehalis
cji	Чамалинский
cjk	Chokwe
cjk-ZM-chokwe	Chokwe
cjm	Đông Chăm
cjn	Chenapian
cjo	Ashéninka Pajonal
cjp	Cabécar
cjs	Шорский
cjv	Chuave
cjy	晋语
ckb	سورانی
ckh	Chak
ckl	Cibak
ckm	Chakavian
ckn	Kaang Chin
cko	Anufo
ckq	Kajakse
ckr	Kairak
cks	Tayo
ckt	Чукотский
cku	Koasati
ckv	Kavalan
ckx	Caka
cky	Cakfem-Mushere
ckz	Cakchiquel-Quiché Mixed Language
cla	Ron
clc	Chilcotin
cld	ܣܘܼܪܲܝܬ
cle	Lealao Chinantec
clh	چیلیسو
cli	Chakali
clj	Laitu Chin
clk	Idu-Mishmi
cll	Chala
clm	Clallam
clo	Lowland Oaxaca Chontal
clt	Lautu Chin
clu	Caluyanun
clw	Чулымский
cly	Eastern Highland Chatino
cma	Maa
cme	Cerma
cmg	Classical Mongolian
cmi	Emberá-Chamí
cml	Campalagian
cmm	Michigamea
cmn	官话
cmn-x-gesu	Gesu
cmn-x-omc	Oral Mandarin Chinese
cmo	Central Mnong
cmo-x-trin	T.rin
cmr	Mro-Khimi Chin
cms	Messapic
cmt	Camtho
cna	Changthang
cnb	Chinbon Chin
cnc	Côông
cng	Northern Qiang
cnh	Haka Chin
cni	Asháninka
cnk	Khumi Chin
cnk-x-kanise	Kanise Khumi
cnk-x-khumileo	Khumi Le-o
cnl	Lalana Chinantec
cno	Con
cns	Central Asmat
cnt	Tepetotutla Chinantec
cnu	لهجة شناوية
cnw	Ngawn Chin
cnx	Middle Cornish
co	corsu, lingua corsa
coa	Cocos Islands Malay
cob	Chicomuceltec
coc	Cocopa
cod	Cocama-Cocamilla
coe	Koreguaje
cof	Colorado
cog	ภาษาชอง
cog-x-kola	Kola
coh	Chonyi-Dzihana-Kauma
coh-x-jibana	Jibana
coh-x-kauma	Kauma
coj	Cochimi
cok	Santa Teresa Cora
col	Columbia-Wenatchi
com	Comanche
con	Cofán
coo	Comox
cop	لغة قبطية
cot	Caquinte
cou	Wamey
cov	草苗
cow	Cowlitz
cox	Nanti
coz	Chochotec
cpa	Palantla Chinantec
cpb	Ucayali-Yurúa Ashéninka
cpc	Ajyíninka Apurucayali
cpg	Cappadocian Greek
cpi	Chinese Pidgin English
cpn	Cherepon
cpo	Kpeego
cps	Capiznon
cpu	Pichis Ashéninka
cpx	莆仙话
cpy	South Ucayali Ashéninka
cqd	苗语川黔滇方言
cqd-x-huamiao	Hua Miao
cqd-x-huomiao	Huo Miao
cqu	Chilean Quechua
cr	ᓀᐦᐃᔭᐍᐏᐣ
cra	Chara
crb	Island Carib
crc	Lonwolwol
crd	Coeur d'Alene
crg	Michif
crh	Crimean Tatar
cri	Sãotomense
crj	Southern East Cree
crk	Plains Cree
crl	Northern East Cree
crm	Moose Cree
crn	El Nayar Cora
cro	Crow
crq	Iyo'wujwa Chorote
crr	Carolina Algonquian
crs	Seselwa Creole French
crt	Iyojwa'ja Chorote
crv	Chaura
crw	Chrau
crx	Carrier
cry	Cori
crz	Cruzeño
cs	čeština, český jazyk
csa	Chiltepec Chinantec
csb	Kashubian
csc	Catalan Sign Language
csd	Chiangmai Sign Language
cse	Czech Sign Language
csf	Cuba Sign Language
csg	Chilean Sign Language
csh	Asho Chin
csi	Coast Miwok
csj	Songlai Chin
csk	Jola-Kasa
csl	中国手语
csl-x-nechinsl	North East China Sign Language
csm	Central Sierra Miwok
csn	Colombian Sign Language
cso	Sochiapam Chinantec
csq	Croatia Sign Language
csr	Costa Rican Sign Language
css	Southern Ohlone
cst	Northern Ohlone
csv	Sumtu Chin
csw	Swampy Cree
csy	Siyin Chin
csz	Coos
cta	Tataltepec Chatino
ctc	Chetco
ctd	Tedim Chin
cte	Tepinapa Chinantec
ctg	Chittagonian
cth	Thaiphum Chin
ctl	Tlacoatzintepec Chinantec
ctm	Chitimacha
ctn	छिन्ताङ्
cto	Emberá-Catío
ctp	Western Highland Chatino
cts	Northern Catanduanes Bikol
cts-x-pangyan	Pangyan
ctt	Wayanad Chetti
ctu	Chol
ctz	Zacatepec Chatino
cu	ѩзыкъ словѣньскъ
cua	Tiếng Co
cub	Cubeo
cuc	Usila Chinantec
cug	Cung
cuh	Chuka
cui	Cuiba
cuj	Mashco Piro
cuk	San Blas Kuna
cul	Culina
cuo	Cumanagoto
cup	Cupeño
cuq	仡隆語
cur	Chhulung
cut	Teutila Cuicatec
cuu	傣雅语
cuv	Cuvok
cuw	Chukwa
cux	Tepeuxila Cuicatec
cv	чӑваш чӗлхи
cvg	Chug
cvn	Valle Nacional Chinantec
cwa	Kabwa
cwb	Maindo
cwd	Woods Cree
cwe	Kwere
cwg	Chewong
cwt	Kuwaataay
cy	Cymraeg
cya	Nopala Chatino
cyb	Cayubaba
cyo	Cuyonon
czh	徽州话
czk	Knaanic
czn	Zenzontepec Chatino
czo	闽中语
czt	Zotung Chin
da	dansk
daa	Dangaléat
dac	Dambi
dad	Marik
dad-x-lagogen	Lagogen
dae	Duupa
dag	Dagbani
dah	Gwahatike
dai	Day
daj	Dar Fur Daju
dak	Dakota
dal	Dahalo
dam	Damakawa
dao	Daai Chin
dao-x-yindu	Daa Yin Du
daq	Dandami Maria
dar	Даргинский
das	Daho-Doo
dau	Dar Sila Daju
dav	Taita
daw	Davawenyo
dax	Dayi
day-x-dayakmali	Dayak Mali
day-x-dayaksambas	Dayak Sambas
daz	Dao
dba	Bangime
dbb	Deno
dbd	Dadiya
dbe	Dabe
dbf	Edopi
dbg	Dogul Dom Dogon
dbi	Doka
dbj	Ida'an
dbl	Dyirbal
dbm	Duguri
dbn	Duriankere
dbo	Dulbu
dbp	Duwai
dbq	Daba
dbr	Dabarre
dbt	Ben Tey Dogon
dbu	Bondum Dom Dogon
dbv	Dungu
dbw	Bankan Tey Dogon
dby	Dibiyaso
dcc	Deccan
dda	Dadi Dadi
ddd	Dongotono
dde	Doondo
ddg	Fataluku
ddi	West Goodenough
ddi-x-amoli	Amoli
ddj	Jaru
ddn	Dendi (Benin)
ddo	цезйас мец
ddr	Dhudhuroa
dds	Donno So Dogon
ddw	Dawera-Daweloor
de	Deutsch
dec	Dagik
ded	Dedua
dee	Dewoin
def	گویش دزفولی
deg	Degema
deh	Dehwari
dei	Demisa
dek	Dek
del	Delaware
dem	Dem
den	Slave (Athapascan)
deq	Dendi (Central African Republic)
der	Deori
des	Desano
dev	Domung
dez	Dengese
dga	Southern Dagaare
dgb	Bunoge Dogon
dgc	Casiguran Dumagat Agta
dgc-x-agtaquirino	Agta-Quirino
dgc-x-dinapigue	Dinapigue Agta
dgd	Dagaari Dioula
dge	Degenan
dgg	Doga
dgh	Dghwede
dgi	Northern Dagara
dgk	Dagba
dgl	Andaandi
dgo	Dogri (individual language)
dgr	Dogrib
dgs	Dogoso
dgu	Degaru
dgw	Daungwurrung
dgx	Doghoro
dgz	Daga
dhd	Dhundari
dhd-x-sindoli	Sindoli
dhg	Dhangu
dhi	धिमाल
dhl	Dhalandji
dhm	Zemba
dhn	Dhanki
dho	Dhodia
dhr	Dhargari
dhs	Dhaiso
dhv	Dehu
dhw	Dhanwar (Nepal)
dhx	Dhungaloo
dia	Dia
dib	South Central Dinka
dic	Lakota Dida
dic-x-dahawan	Dahawan
dic-x-djiboua	Djiboua
dic-x-vata	Dida Vata
did	Didinga
dif	Dieri
dig	Digo
dih	Kumiai
dii	Dimbong
dii-x-bape	Bape
dij	Dai
dik	Southwestern Dinka
dil	Dilling
dim	Dime
din	Dinka
dio	Dibo
dip	Northeastern Dinka
diq	Dimli (individual language)
dir	Dirim
dis	Dimasa
diu	Gciriku
diu-x-rusambiu	Rusambiu
diw	Northwestern Dinka
dix	Dixon Reef
diy	Diuwe
diz	Ding
diz-x-kidikidiki	Kidikidiki
djb	Djinba
djc	Dar Daju Daju
djd	Djamindjung
dje	Zarma
dji	Djinang
djj	Djeebbana
djk	Eastern Maroon Creole
djm	Jamsay Dogon
djn	Djauan
djo	Jangkang
djo-x-dayakbaeih	Dayak Ba eih
djo-x-dayakdarok	Dayak Darok
djo-x-dayakkodatn	Dayak Kodatn
djo-x-dayakpapak	Dayak Papak
djo-x-dayaksum	Dayak Sum
djo-x-dayaktinying	Dayak Tinying
djo-x-meranggau	Dayak Meranggau
djo-x-pompang	Dayak Pompang
djr	Djambarrpuyngu
dju	Kapriman
dka	Dakpakha
dkg	Kadung
dkk	Dakka
dkr	Kuijau
dks	Southeastern Dinka
dkx	Mazagway
dlg	Долганский
dlk	Dahalik
dlm	Dalmatian
dln	Darlong
dma	Duma
dmb	Mombo Dogon
dmc	Gavak
dme	Dugwor
dmg	Upper Kinabatangan
dmk	ڈوماکی
dml	دامیڑی
dmm	Dama
dmo	Kemezung
dmr	East Damar
dms	Dampelas
dmu	Dubu
dmv	Dumpas
dmw	Mudburra
dmx	Dema
dmy	Demta
dna	Upper Grand Valley Dani
dnd	Daonda
dne	Ndendeule
dng	Dungan
dni	Lower Grand Valley Dani
dnj	Dan
dnk	Dengka
dnk-x-laelete	Laelete
dnn	Dzùùngoo
dnr	Danaru
dnr-x-kuaa	Kuaa
dnt	Mid Grand Valley Dani
dnt-x-balimselatan	Hugula Balim Selatan
dnt-x-balimtenga	Hugula Balim Tengah
dnt-x-balimutara	Hugula Balim Utara
dnu	Danau
dnv	Danu
dnw	Western Dani
dny	Dení
doa	Dom
dob	Dobu
dob-x-gosiya	Gosiya
dob-x-kaugehu	Kaugehu
doc	北侗語
doe	Doe
dof	Domu
doh	Dong
doi	Dogri (macrolanguage)
dok	Dondo
dol	Doso
don	Toura (Papua New Guinea)
doo	Dongo
dop	Lukpa
doq	Dominican Sign Language
dor	Dori'o
dos	Dogosé
dot	Dass
dov	Tonga
dow	Doyayo
dox	Bussa
doy	Dompo
doz	Dorze
dpp	Papar
drb	Dair
drc	Minderico
drd	Darmiya
dre	Dolpo
drg	Rungus
drg-x-gonsomon	Gonsomon
drg-x-pilapazan	Pilapazan
dri	C'lela
drl	Paakantyi
drn	West Damar
dro	Daro-Matu Melanau
drq	Dura
drs	Gedeo
drt	Drents
dru	Rukai
dry	Darai
dsb	Lower Sorbian
dse	Dutch Sign Language
dse-x-gambiansl	Gambian Sign Language
dsh	Daasanach
dsi	Disa
dsl	Danish Sign Language
dsn	Dusner
dso	Desiya
dso-Deva-bastaridesia	Bastaria Desia
dso-x-korapdesia	Koraputia Desia
dsq	Tadaksahak
dta	达斡尔语
dtb	Labuk-Kinabatangan Kadazan
dtd	Ditidaht
dti	Ana Tinga Dogon
dtk	Tene Kan Dogon
dtm	Tomo Kan Dogon
dto	Tommo So Dogon
dtp	Central Dusun
dtp-x-tindal	Tindal
dtr	Lotud
dts	Toro So Dogon
dtt	Toro Tegu Dogon
dtu	Tebul Ure Dogon
dty	डोटेली
dua	Duala
dub	Dubli
duc	Duna
dud	Hun-Saare
due	Umiray Dumaget Agta
duf	Dumbea
dug	Duruma
duh	Dungra Bhil
dui	Dumun
duj	Dhuwal
duk	Uyajitaya
duk-x-buai	Buai
duk-x-duduela	Duduela
dul	Alabat Island Agta
dum	Middle Dutch (ca. 1050-1350)
dun	Dusun Deyah
duo	Dupaninan Agta
dup	Duano
duq	Dusun Malang
duq-x-dusunbayan	Dusun Bayan
dur	Dii
dus	Dumi
duu	独龙语
duv	Duvle
duw	Dusun Witu
duw-x-dusunpepas	Dusun Pepas
dux	Duungooma
dv	ދިވެހި
dva	Duau
dwa	Diri
dwr	Dawro
dws	Dutton World Speedwords
dww	Dawawa
dya	Dyan
dyi	Djimini Senoufo
dym	Yanda Dom Dogon
dyo	Jola-Fonyi
dyu	Dyula
dyy	Dyaabugay
dz	རྫོང་ཁ
dza	Tunzuii
dzg	Dazaga
dzl	Dzalakha
dzn	Dzando
eaa	Karenggapa
ebg	Ebughu
ebk	Eastern Bontok
ebo	Teke-Ebo
ebr	Ebrié
ebu	Embu
ecr	Eteocretan
ecs	Ecuadorian Sign Language
ecy	Eteocypriot
ee	Eʋegbe
eee	诶话
efa	Efai
efe	Efe
efi	Efik
ega	Ega
egl	Emilian
ego	Eggon
egy	Egyptian (Ancient)
ehu	Ehueun
eip	Eipomek
eit	Eitiep
eiv	Askopan
eja	Ejamat
eja-x-arame	Aramé
eka	Ekajuk
eke	Ekit
ekg	Ekari
eki	Eki
ekk	Standard Estonian
ekl	Kol (Bangladesh)
ekm	Elip
eko	Koti
eko-x-ecoti	Koti Ecoti
ekp	Ekpeye
ekr	Yace
eky	Eastern Kayah
el	ελληνικά
ele	Elepi
elh	El Hugeirat
eli	Nding
elk	Elkei
elm	Eleme
elo	El Molo
elu	Elu
elx	Elamite
el-x-koine	Koine Greek
ema	Emai-Iuleha-Ora
ema-x-emai	Emai
ema-x-erah	Erah
ema-x-ora	Ora
ema-x-ozalla	Ozalla
ema-x-uokha	Uokha
emb	Embaloh
emb-x-kalis	Dayak Kalis
eme	Emerillon
emg	Eastern Meohang
emi	Mussau-Emira
emk	Eastern Maninkakan
emm	Mamulique
emn	Eman
emp	Northern Emberá
ems	Pacific Gulf Yupik
emu	Eastern Muria
emw	Emplawas
emx	Erromintxela
emy	Epigraphic Mayan
emz	Mbessa
en	English
ena	Apali
enb	Markweeta
enb-x-kiptani	Kiptani
enb-x-sengwer	Sengwer
enc	En
end	Ende
enf	Энецкий
eng-x-bermudengl	Bermudan English
eng-x-stdavideng	St David's Islander
enh	Энецкий
enl	Enlhet
enm	Middle English (1100-1500)
enn	Engenni
eno	Enggano
enq	Enga
enq-x-mai	Mai
enr	Emumu
enu	西摩洛
env	Enwan (Edu State)
enw	Enwan (Akwa Ibom State)
enx	Enxet
en-x-demo1	English demo1
en-x-demo2	English demo2
eo	Esperanto
eot	Beti (Côte d'Ivoire)
epi	Epie
era	Eravallan
erg	Sie
erg-x-empack	Empack
erg-x-enyeu	Enyeu
erg-x-imaptap	Imaptap
erg-x-potnariven	Potnariven
erg-x-sorung	Sorung
erg-x-yoku	Yoku
erh	Eruwa
eri	Ogea
eri-x-marak	Marak
erk	South Efate
erk-x-epang	Epang
erk-x-erakor	Erakor
erk-x-eratap	Eratap
ero	尔龚语
ers	尔苏
ert	Eritai
erw	Erokwanas
es	español
es-419	Español Latin America
ese	Ese Ejja
esh	Eshtehardi
esi	North Alaskan Inupiatun
esk	Northwest Alaska Inupiatun
esl	لغة الإشارة المصرية
esm	Esuma
esn	Salvadoran Sign Language
eso	Estonian Sign Language
esq	Esselen
ess	Central Siberian Yupik
esu	Central Yupik
esy	Eskayan
et	eesti, eesti keel
etb	Etebi
etc	Etchemin
eth	Ethiopian Sign Language
etn	Eton (Vanuatu)
etn-x-fesan	Fesan
eto	Eton (Cameroon)
etr	Edolo
ets	Yekhee
ett	Etruscan
etu	Ejagham
etx	Eten
etz	Semimi
eu	euskara, euskera
eve	Эвенский
evh	Uvbie
evn	鄂温克语
ewo	Ewondo
ewo-x-baveck	Baveck
ext	Extremaduran
eya	Eyak
eyo	Keiyo
eza	Ezaa
eze	Uzekwe
fa	فارسی
faa	Fasu
fab	Fa d'Ambu
fad	Wagi
fad-x-kamba	Kamba
faf	Fagani
fag	Finongan
fah	Baissa Fali
fai	Faiwol
faj	Faita
fak	Fang (Cameroon)
fal	South Fali
fam	Fam
fan	Fang (Equatorial Guinea)
fan-x-malabo	Malabo Fang
fan-x-mvae	Mvae
fap	Palor
far	Fataleka
far-x-iduleka	Iduleka
fas-x-eastfars	دری
fat	Fanti
fau	Fayu
fax	Fala
fay	گویش دوانی
faz	Northwestern Fars
fbl	West Albay Bikol
fcs	Quebec Sign Language
fer	Feroge
ff	Fulfulde, Pulaar, Pular
ffi	Foia Foia
ffm	Maasina Fulfulde
fgr	Fongoro
fi	suomi, suomen kieli
fia	Nobiin
fie	Fyer
fif	Faifi
fij-x-koroalau	Koroalau
fij-x-lovoni	Lovoni
fij-x-saqani	Saqani
fij-x-vaturova	Vaturova
fij-x-vugalei	Vugalei
fil	Filipino
fip	Fipa
fip-x-kwa	Kwa
fir	Firan
fit	Tornedalen Finnish
fiw	Fiwaga
fj	vosa Vakaviti
fkk	Kirya-Kondzəl
fkv	Kven Finnish
fla	Kalispel-Pend d'Oreille
flh	Foau
fli	Fali
fll	North Fali
flr	Fuliiru
flr-x-kimwanaka	Kimwanaka
fly	Flaaitaal
fmp	Fe'fe'
fmu	Far Western Muria
fng	Fanagalo
fni	Fania
fo	føroyskt
fod	Foodo
foi	Foi
fom	Foma
fon	Fon
for	Fore
for-x-abomatasa	Abomatasa
for-x-foreati	Fore Ati
for-x-forepamusa	Pamusa
for-x-kiya	Fore Kiya
for-x-pamusa	Fore Pamusa
fos	Siraya
fpe	Fernando Po Creole English
fqs	Fas
fr	français, langue française
frc	Cajun French
frd	Fordata
frk	Frankish
frm	Middle French (ca. 1400-1600)
fro	Old French (842-ca. 1400)
frp	Arpitan
frq	Forak
frr	Northern Frisian
frs	Eastern Frisian
frt	Fortsenal
fse	Finnish Sign Language
fsl	French Sign Language
fss	Finland-Swedish Sign Language
fub	Adamawa Fulfulde
fuc	Pulaar
fud	East Futuna
fue	Borgu Fulfulde
fuf	Pular
fuh	Western Niger Fulfulde
fuh-x-jelgoore	Jelgoore
fui	Bagirmi Fulfulde
fuj	Ko
fum	Fum
fun	Fulniô
fuq	Central-Eastern Niger Fulfulde
fur	Friulian
fut	Futuna-Aniwa
fuu	Furu
fuv	Nigerian Fulfulde
fuy	Fuyuge
fvr	Fur
fvr-SS-fur	Fur / Poor
fvr-TD-fur	Fur
fvr-x-fur	Fur
fwa	Fwâi
fwe	Fwe
fy	Frysk
ga	Gaeilge
gaa	Ga
gab	Gabri
gac	Mixed Great Andamanese
gad	Gaddang
gae	Guarequena
gaf	Gende
gag	Gagauz
gah	Alekano
gah-x-lapigufimi	Lapigu Fimito
gai	Borei
gaj	Gadsup
gaj-x-aiyuree	Kasup Aiyuree
gaj-x-aygm	Gadsup Ayugam
gaj-x-kamu	Gadsup Kamu
gaj-x-kasupbina	Kasup Bina
gaj-x-norikori	Norikori
gaj-x-omaura	Gadsup Omaura
gaj-x-urona	Gadsup Urona
gaj-x-wandamo	Wandamo
gaj-x-ymnk	Gadsup Yomunka
gak	Gamkonora
gal	Galolen
gam	Kandawo
gan	贛語
gao	Gants
gap	Gal
gaq	Gata'
gar	Galeya
gas	Adiwasi Garasia
gat	Kenati
gau	Mudhili Gadaba
gaw	Nobonob
gaw-x-arinai	Ari-Nai
gax	Borana-Arsi-Guji Oromo
gax-x-ajuran	Ajuran
gay	Gayo
gaz	West Central Oromo
gba	Gbaya (Central African Republic)
gbb	Kaytetye
gbd	Karadjeri
gbe	Niksek
gbf	Gaikundi
gbg	Gbanziri
gbh	Defi Gbe
gbi	Galela
gbj	Bodo Gadaba
gbk	Gaddi
gbl	Gamit
gbm	Garhwali
gbm-x-chanquotia	Chanquotia
gbn	Mo'da
gbo	Northern Grebo
gbp	Gbaya-Bossangoa
gbq	Gbaya-Bozoum
gbr	Gbagyi
gbs	Gbesi Gbe
gbu	Gagadu
gbv	Gbanu
gbw	Gabi-Gabi
gbx	Eastern Xwla Gbe
gby	Gbari
gbz	گویش بهدینان
gcc	Mali
gcd	Ganggalida
gcf	Guadeloupean Creole French
gcl	Grenadian Creole English
gcn	Gaina
gcr	Guianese Creole French
gct	Colonia Tovar German
gd	Gàidhlig
gda	Gade Lohar
gdb	Pottangi Ollar Gadaba
gdc	Gugu Badhun
gdd	Gedaged
gde	Gude
gdf	Guduf-Gava
gdg	Ga'dang
gdh	Gadjerawang
gdi	Gundi
gdj	Gurdjar
gdk	Gadang
gdl	Dirasha
gdm	Laal
gdn	Umanakaina
gdo	Годоберинский
gdq	لغة مهرية
gdr	Wipi
gds	Ghandruk Sign Language
gdu	Gudu
gdx	Godwari
gea	Geruma
geb	Kire
gec	Gboloo Grebo
ged	Gade
geg	Gengle
geh	Hutterite German
gei	Gebe
gej	Gen
gek	Yiwom
gel	ut-Ma'in
geq	Geme
ges	Geser-Gorom
gev	Eviya
gew	Gera
gex	Garre
gey	Enya
gez	Geez
gfk	Patpatar
gfk-x-hinsal	Hinsal
gfk-x-sokirak	Sokirak
gft	Gafat
gga	Gao
ggb	Gbii
gge	Guragone
ggg	Gurgula
ggl	Ganglau
ggn	Eastern Gurung
ggo	Southern Gondi
ggt	Gitua
ggu	Gagu
ggw	Gogodala
gha	لهجة غدامسية
ghc	Hiberno-Scottish Gaelic
ghe	Southern Ghale
ghh	Northern Ghale
ghk	Geko Karen
ghl	Ghulfan
ghn	Ghanongga
gho	ⵖⵓⵎⴰⵔⴰ
ghr	Ghera
ghs	Guhu-Samane
ghs-x-biahonoo	Bia ho noo
ghs-x-biawaria	Biawaria
ght	Kuke
gia	Kitja
gib	Gibanawa
gic	Gail
gid	Gidar
gie	Garo
gig	Goaria
gih	Githabul
gil	Gilbertese
gim	Gimi (Eastern Highlands)
gim-x-ibusakava	Ibusakava
gim-x-ovavo	Ovavo
gin	Гинухский
gio	仡佬
gio-x-naza	Naza
gip	Gimi (West New Britain)
giq	Hagei
gir	红仡佬语
gis	North Giziga
git	Gitxsan
giu	仡佬
giw	青仡佬语
gix	Gilima
giy	Giyug
giz	South Giziga
gjk	Kachi Koli
gjn	Gonja
gju	Gujari
gju-x-rajistani	Gujur Rajistani
gka	Guya
gke	Ndai
gkn	Gokana
gkp	Guinea Kpelle
gl	galego
glb	Belning
glc	Bon Gula
gld	Нанайский
glh	Northwest Pashai
glj	Gula Iro
glk	زبان گیلکی
glo	Galambu
glr	Glaro-Twabo
glu	Gula
glw	Glavda
gly	Gule
gmb	Gula'alaa
gmd	Mághdì
gmg	Magɨyi
gmh	Middle High German (ca. 1050-1500)
gml	Middle Low German
gmm	Gbaya-Mbodomo
gmn	Gimnime
gmu	Gumalu
gmv	Gamo
gmx	Magoma
gmy	Mycenaean Greek
gmz	Mgbolizhia
gn	Avañe'ẽ
gna	Kaansa
gnb	Gangte
gnc	Guanche
gnd	Zulgo-Gemzek
gne	Ganang
gng	Ngangam
gnh	Lere
gni	Gooniyandi
gnk	ǁGana
gnm	Ginuman
gnn	Gumatj
gno	Northern Gondi
gno-x-rajgondi	Raj Gondi
gnq	Gana
gnr	Gureng Gureng
gnt	Guntai
gnu	Gnau
gnw	Western Bolivian Guaraní
gnz	Ganzi
goa	Guro
gob	Playero
goc	Gorakor
god	Godié
god-x-kohiri	Godié Kôhiri
goe	Gongduk
gof	Gofa
gog	Gogo
goh	Old High German (ca. 750-1050)
goi	Gobasi
goj	Gowlan
gok	Gowli
gol	Gola
gom	Goan Konkani
gon	Gondi
gon-x-mariagond	Maria Gond
goo	Gone Dau
gop	Yeretuar
goq	Gorap
gor	Gorontalo
gos	Gronings
got	Gothic
gou	Gavar
gow	Gorowa
gox	Gobu
goy	Goundo
goz	Gozarkhani
gpa	Gupa-Abawa
gpe	Ghanaian Pidgin English
gpn	Taiap
gqa	Ga'anda
gqa-x-kabinda	Kaɓǝnda
gqi	貴瓊
gqn	Guana (Brazil)
gqr	Gor
gqu	稿方言
gra	Rajput Garasia
grb	Grebo
grc	Ancient Greek
grd	Guruntum-Mbaaru
grg	Madi
grh	Gbiri-Niragu
gri	Ghari
grj	Southern Grebo
grm	Kota Marudu Talantang
gro	Groma
grq	Gorovu
grr	تازناتيت
grr-x-figuigber	Figuig Berber
grs	Gresi
grt	Garo
gru	Kistane
grv	Central Grebo
grw	Gweda
grx	Guriaso
gry	Barclayville Grebo
grz	Guramalum
gse	Ghanaian Sign Language
gsg	German Sign Language
gsl	Gusilay
gsm	Guatemalan Sign Language
gsn	Gusan
gso	Southwest Gbaya
gsp	Wasembo
gss	Greek Sign Language
gsw	Swiss German
gta	Guató
gu	ગુજરાતી
gua	Shiki
gub	Guajajára
guc	Wayuu
guc-x-wayuumedi	Wayuunaiki Media
guc-x-wayuunalt	Wayuunaiki Alta
gud	Yocoboué Dida
gud-x-gbehiri	Gbéhiri
gud-x-meehiri	Menehiri
gud-x-souamlin	Souamlin
gue	Gurinji
guf	Gupapuyngu
gug	Paraguayan Guaraní
guh	Guahibo
gui	Eastern Bolivian Guaraní
guk	Gumuz
gul	Sea Island Creole English
gum	Guambiano
gun	Mbyá Guaraní
guo	Guayabero
gup	Gunwinggu
guq	Aché
gur	Farefare
gur-x-nabt	Nabt
gus	Guinean Sign Language
gut	Maléku Jaíka
guu	Yanomamö
guv	Gey
guw	Gun
gux	Gourmanchéma
gux-x-gourmantche	Gourmantche
guz	Gusii
gv	Gaelg, Gailck
gva	Guana (Paraguay)
gvc	Guanano
gve	Duwet
gvf	Golin
gvf-x-kopan	Kopan
gvf-x-kunanaku	Kunanaku
gvj	Guajá
gvl	Gulay
gvm	Gurmana
gvn	Kuku-Yalanji
gvo	Gavião Do Jiparaná
gvp	Pará Gavião
gvr	Western Gurung
gvs	Gumawana
gwa	Mbato
gwb	Gwa
gwc	گاوری زبان
gwd	Gawwada
gwe	Gweno
gwf	گوورو
gwg	Moo
gwi	Gwichʼin
gwj	|Gwi
gwn	Gwandara
gwr	Gwere
gwt	Gawar-Bati
gww	Kwini
gwx	Gua
gxx	Wè Southern
gya	Northwest Gbaya
gyb	Garus
gyb-x-emnam	Emnam
gyb-x-emnin	Emnin
gyd	Kayardild
gye	Gyem
gyg	Gbayi
gyi	Gyele
gyl	Gayil
gym	Ngäbere
gyn	Guyanese Creole English
gyr	Guarayu
gyz	Gyaazi
gza	Ganza
gzi	Gazi
gzn	Gane
ha	(Hausa) هَوُسَ
haa	Han
hab	Ngôn ngữ ký hiệu Hà Nội
hac	گۆرانی
had	Hatam
had-x-moile	Moile
hae	Eastern Oromo
haf	Ngôn ngữ ký hiệu Hải Phòng
hag	Hanga
hah	Hahon
hai	Haida
haj	Hajong
hak	客家語
hak-ID-kalimanhak	Kalimantan Hakka Chinese
hal	Halang
ham	Hewa
han	Hangaza
hao	Haku
hap	Hupla
haq	Ha
haq-x-jiji	Jiji
haq-x-lawanyenka	Lawanyenkanda
haq-x-tusi	Tusi
haq-x-wanyahiru	Wanyahiru
har	Harari
has	Haisla
hav	Havu
hav-x-kigendo	Kigendo
hav-x-kihavuidjui	Kihavu Idjui
haw	Hawaiian
hax	Southern Haida
hay	Haya
hay-x-kiziba	Kiziba
hay-x-nyaihangiro	Kinyaihangiro
haz	آزرگی
hba	Hamba
hbb	Huba
hbn	Heiban
hbo	Ancient Hebrew
hbs	Serbo-Croatian
hbu	Habu
hca	Andaman Creole Hindi
hch	Huichol
hch-x-huicholeste	Huicholes del este
hch-x-wixarika	Wixarika
hdn	Northern Haida
hds	Honduras Sign Language
hdy	Hadiyya
he	עברית
hea	北部土语
hed	Herdé
heg	Helong
heh	Hehe
hei	Heiltsuk
hem	Hemba
hem-x-kayungu	Kayungu
hem-x-yambula	Yambula
her-BW-otjimbande	Otjimbanderu
hgm	Hai||om
hgw	Haigwai
hhi	Hoia Hoia
hhr	Kerak
hhy	Hoyahoya
hi	हिन्दी, हिंदी
hia	Lamang
hid	Hidatsa
hif	Fiji Hindi
hig	Kamwe
hih	Pamosu
hih-x-yoro	Yoro
hii	Hinduri
hij	Hijuk
hik	Seit-Kaitetu
hil	Hiligaynon
hio	Tsoa
hir	Himarimã
hit	Hittite
hiw	Hiw
hix	Hixkaryána
hi-x-bhartali	Bhartali Khadiboli
hi-x-dcv	हिन्दी, हिंदी - Dominant Culture Variant
hi-x-dehathi	Dehathi Hindi
hi-x-pawani	Pawani
hi-x-waradhi	Waradhi
hji	Haji
hka	Kahe
hke	Hunde
hke-x-bakobo	Bakobo
hkk	Hunjara-Kaina Ke
hkk-x-hunjara	Hunjara
hkn-x-mel	Mel
hkn-x-melkhaonh	Mel-Khaonh
hks	Hong Kong Sign Language
hla	Halia
hlb	Halbi
hlb-x-chandari	Chandar Bhasha
hld	Halang Doan
hle	勒苏
hlt	Matu Chin
hlu	Hieroglyphic Luwian
hma	麻山
hmb	Humburi Senni Songhay
hmc	Central Huishui Hmong
hmd	大花苗
hme	Eastern Huishui Hmong
hmf	Mông Don
hmg	Southwestern Guiyang Hmong
hmh	Southwestern Huishui Hmong
hmi	Northern Huishui Hmong
hmj	家语
hmk	Maek
hml	罗泊河
hmm	中部土语
hmn	囊括代码
hmp	麻山
hmq	东部土语
hmr	Hmar
hms	南部土语
hmt	Hamtai
hmu	Hamap
hmv	Mông Đỏ
hmv-x-do	Do
hmw	西部土语
hmy	Southern Guiyang Hmong
hmz	汉苗方言
hna	Mina (Cameroon)
hnd	ہندکو
hne	Chhattisgarhi
hne-x-khaltahi	Khaltahi
hnh	||Ani
hni	哈尼语
hni-x-Bu4Du1 Hani	Bu4Du1 Hani
hni-x-budu	Bu4du4 Hani
hni-x-longpuha	Longpu Hani
hni-x-yicei	Yicei
hnj	Hmong Njua
hnj-CN-qingmiao	Miao, Qing
hnn	Hanunoo
hno	Northern Hindko
hns	Caribbean Hindustani
hnu	Hung
ho	Hiri Motu
hoa	Hoava
hob	Mari (Madang Province)
hoc	Ho
hoe	Horom
hoh	لغة هوبيوت
hoi	Holikachuk
hoj	Hadothi
hol	Holu
hoo	Holoholo
hop	Hopi
hos	Ngôn ngữ ký hiệu Thành phố Hồ Chí Minh
hot	Hote
hov	Hovongan
hov-x-punanuheng	Dayak Punan Uheng
how	Honi
hoy	Holiya
hoz	Hozo
hpo	Hpon
hps	Hawai'i Sign Language (HSL)
hr	hrvatski jezik
hra	Hrangkhol
hrc	Niwer Mil
hre	Tiếng Hrê
hrk	Haruku
hrm	角苗方言
hro	Haroi
hrt	Hértevin
hru	Hruso
hru-x-aka	Aka
hrw	Warwar Feni
hrx	Hunsrik
hrz	هرزندی، هرزنی
hsb	Upper Sorbian
hsh	Hungarian Sign Language
hsl	Hausa Sign Language
hsn	湘
hsn-x-liupanshui	Miao, Liupanshui
hss	لغة حرسوسية
ht	Kreyòl ayisyen
hto	Minica Huitoto
hts	Hadza
htu	Hitu
htx	Middle Hittite
hu	magyar
hub	Huambisa
huc	ǂHua
hud	Huaulu
hue	San Francisco Del Mar Huave
huf	Humene
hug	Huachipaeri
huh	Huilliche
hui	Huli
huj	Northern Guiyang Hmong
hul	Hula
hum	Hungana
huo	户语
hup	Hupa
huq	回辉语
hur	Halkomelem
hus	Huastec
hut	Humla
huu	Murui Huitoto
huv	San Mateo Del Mar Huave
hux	Nüpode Huitoto
huy	יהודיותא
huz	Гунзибский
hvc	Haitian Vodoun Culture Language
hve	San Dionisio Del Mar Huave
hvk	Haveke
hvn	Sabu
hvv	Santa María Del Mar Huave
hwa	Wané
hwc	Hawai'i Creole English
hwo	Hwana
hy	Հայերեն
hya	Hya
hyw	Western Armenian
hz	Otjiherero
ia	Interlingua
iai	Iaai
ian	Iatmul
iar	Purari
iar-x-iai	Iai
iar-x-koriki	Koriki
iar-x-vaimuru	Vaimuru
iba	Iban
iba-x-	Dayak Sangku
iba-x-baraipenye	Dayak Barai Penyelompat
iba-x-dayakbanjur	Dayak Banjur
iba-x-dayakbugau	Dayak Bugau
iba-x-dayakbunut	Dayak Bunut
iba-x-dayakdesa	Dayak Desa
iba-x-dayaknanga	Dayak Nanga
iba-x-dayaksebaruk	Dayak Sebaruk
iba-x-dayaksekapat	Dayak Sekapat
iba-x-dayakulu	Dayak Ulu
iba-x-desa	Desa
iba-x-desatempunak	Desa Tempunak
iba-x-entebang	Dayak Entebang
iba-x-ibanempran	Dayak Iban Empran
iba-x-kancing'k	Dayak Kancing'k
iba-x-ketior	Dayak Ketior
iba-x-ketungau	Dayak Ketungau
iba-x-ketungausesat	Ketungau Sesaek
iba-x-randuk	Dayak Randuk
iba-x-salako	Dayak Salako
iba-x-sangku	Dayak Sangku
iba-x-sekajang	Dayak Sekajang
iba-x-selawe	Dayak Selawe
iba-x-selibong	Dayak Selibong
iba-x-sepatoi	Dayak Sepatoi
iba-x-siberuang	Dayak Siberuang Sejiram
iba-x-sikung	Dayak Sikung
iba-x-silatmunta	Dayak Silat Muntak
iba-x-sontas	Dayak Sontas
iba-x-sungkung	Dayak Sungkung
iba-x-tadietn	Dayak Tadietn
ibb	Ibibio
ibd	Iwaidja
ibe	Akpes
ibg	Ibanag
ibl	Ibaloi
ibm	Agoi
ibn	Ibino
ibr	Ibuoro
ibu	Ibu
iby	Ibani
ica	Ede Ica
ich	Etkywan
icl	Icelandic Sign Language
icr	Islander Creole English
id	Bahasa Indonesia
ida	Idakho-Isukha-Tiriki
ida-x-isukha	Lwisukha
ida-x-tiriki	Tiriki
idb	Indo-Portuguese
idc	Idon
idd	Ede Idaca
ide	Idere
idi	Idi
idr	Indri
ids	Idesa
idt	Idaté
idu	Idoma
id-x-dcv	Bahasa Indonesia - Dominant Culture Variant
ie	Originally called Occidental; then Interlingue after WWII
ifa	Amganad Ifugao
ifa-x-munibannaw	Mun'ibannawol
ifb	Batad Ifugao
ifb-x-lowayangan	Lower Ayangan
ifb-x-uppayangan	Upper Ayangan
ife	Ifè
ife-x-ana	Ana
ifk	Tuwali Ifugao
ifk-x-yattuca	Yattuca
ifm	Teke-Fuumu
ifu	Mayoyao Ifugao
ify	Keley-I Kallahan
ify-x-munkalyon	Munkalyon
ig	Ásụ̀sụ̀ Ị̀gbò
igb	Ebira
igb-x-etuno	Etuno
igb-x-miyakan	Egbura Miya Kan
ige	Igede
igg	Igana
igl	Igala
igm	Kanggape
ign	Ignaciano
igo	Isebe
igs	Interglossa
igw	Igwe
igw-x-sale	Igwe-Sale
ihb	Iha Based Pidgin
ihi	Ihievbe
ihp	Iha
ihw	Bidhawal
ii	ꆈꌠ꒿ Nuosuhxop
iii-x-baiyi	Baiyi
iii-x-gongjiyi	Gongji Yi
iii-x-luoluo	Luoluo
ijc	Izon
ije	Biseni
ijj	Ede Ije
ijn	Kalabari
ijs	Southeast Ijo
ik	Iñupiaq, Iñupiatun
ike	Eastern Canadian Inuktitut
iki	Iko
ikk	Ika
ikl	Ikulu
iko	Olulumo-Ikom
ikp	Ikpeshi
iks	Inuit Sign Language
ikt	Inuinnaqtun
ikv	Iku-Gora-Ankwa
ikw	Ikwere
ikx	Ik
ikz	Ikizu
ila	Ile Ape
ilb	Ila
ilb-x-lundwe	Lundwe
ilb-x-twa	Twa
ili	伊犁土尔克语
ilk	Ilongot
ilk-x-bugkalot	Bugkalot
ill	Iranun
ilm	Malaysian Iranun
ilo	Iloko
ilp	Philippine Iranun
ils	International Sign
ilu	Ili'uun
ilv	Ilue
ima	Mala Malasar
imi	Anamgura
iml	Miluk
imn	Imonda
imo	Imbongu
imo-x-imboungu	Imbo Ungu Proper
imr	Imroing
ims	Marsian
imy	Milyan
inb	Inga
ing	Degexit'an
inh	Ингушский
inj	Jungle Inga
inl	Indonesian Sign Language
inm	Minaean
inn	Isinai
ino	Inoke-Yate
inp	Iñapari
ins	Indian Sign Language
ins-x-andrapsl	Andra Pradesh Sign Language
ins-x-karnatsl	Karnataka Sign Language
ins-x-keralasl	Malayalam Sign Language
ins-x-marathisl	Marathi Sign Language
ins-x-tamnadsl	Tamil Nadu Sign Language
ins-x-telugusl	Telugu Sign Language
int	Intha
inz	Ineseño
io	Ido
ior	Inor
iou	Tuma-Irumu
iow	Iowa-Oto
ipi	Ipili
ipo	Ipiko
iqu	Iquito
iqw	Ikwo
ire	Iresim
irh	Irarutu
iri	Irigwe
irk	Iraqw
irn	Irántxe
irr	Ir
iru	Irula
iru-x-nayak	Iruli Nayak
irx	Kamberau
iry	Iraya
is	Íslenska
isa	Isabi
isc	Isconahua
isd	Isnag
ise	Italian Sign Language
isg	Irish Sign Language
ish	Esan
isi	Nkem-Nkum
isk	škošmi zəvůk
ism	Masimasi
isn	Isanzu
iso	Isoko
isr	שפת הסימנים הישראלית
ist	Istriot
isu	Isu (Menchum Division)
it	italiano
itb	Binongan Itneg
itd	Southern Tidung
itd-x-dayaktahol	Dayak Tahol
ite	Itene
iti	Inlaod Itneg
itk	Judeo-Italian
itl	Ительменский
itm	Itu Mbon Uzo
ito	Itonama
itr	Iteri
its	Isekiri
itt	Maeng Itneg
itv	Itawit
itw	Ito
itx	Itik
ity	Moyadan Itneg
itz	Itzá
iu	ᐃᓄᒃᑎᑐᑦ
ium	勉語
ium-x-huaku	Huaku Yao
ium-x-lantien	Lan Tien Yao
ium-x-lantin	Lan Tin
ivb	Ibatan
ivv	Ivatan
iwk	I-Wak
iwm	Iwam
iwo	Iwur
iws	Sepik Iwam
ixc	Ixcatec
ixl	Ixil
iya	Iyayu
iyo	Mesaka
iyx	Yaka (Congo)
izh	Ижорский
izr	Izere
izz	Izii
ja	日本語 (にほんご)
jaa	Jamamadí
jab	Hyam
jac	Popti'
jad	Jahanka
jae	Yabem
jaf	Jara
jah	Jah Hut
jaj	Zazao
jak	Jakun
jal	Yalahatan
jam	Jamaican Creole English
jao	Yanyuwa
jaq	Yaqay
jas	New Caledonian Javanese
jat	Jakati
jau	Yaur
jav-x-banyu	Banyumasan
jav-x-cirebon	Cirebon
jav-x-jawatimur	Jawa Timur
jav-x-tegal	Tegal
jax	Jambi Malay
jay	Yan-nhangu
jaz	Jawe
jbe	ברברית יהודית
jbj	Arandai
jbk	Barikewa
jbm	Bijim
jbn	ⵜⴰⵏⴼⵓⵙⵉⵜ
jbo	Lojban
jbr	Jofotek-Bromnya
jbt	Jabutí
jbu	Jukun Takum
jbu-x-fete	Fete
jbw	Yawijibaya
jcs	Jamaican Country Sign Language
jct	Krymchak
jda	Jad
jdg	Jadgali
jdt	Горско-еврейский
jeb	Jebero
jee	Jerung
jeg	Jeng
jeg-x-lawi	Lawi
jeh	Jeh
jei	Yei
jek	Jeri Kuo
jel	Yelmek
jen	Dza
jer	Jere
jer-x-gasi	Gasi
jet	Manem
jet-x-menangki	Menangki
jeu	Jonkor Bourmataguil
jge	ברברית יהודית
jgk	Gwak
jgo	Ngomba
jhi	Jehai
jhs	Jhankot Sign Language
jia	Jina
jib	Jibu
jic	Tol
jid	Bu
jie	Jilbe
jig	Djingili
jih	道孚语
jii	Jiiddu
jil	Jilim
jim	Jimi (Cameroon)
jio	加茂
jiq	绰斯甲语
jit	Jita
jit-x-hambwe	Hambwe
jiu	攸乐基诺语
jiv	Shuar
jiy	补远基诺语
jje	Jejueo
jjr	Bankal
jkm	Mobwa Karen
jko	Kubo
jkp	Paku Karen
jkr	Koro (India)
jku	Labir
jle	Ngile
jls	Jamaican Sign Language
jma	Dima
jmb	Zumbun
jmc	Machame
jmd	Yamdena
jmi	Jimi (Nigeria)
jml	Jumli
jmn	Makuri Naga
jmr	Kamara
jms	Mashi (Nigeria)
jmw	Mouwase
jmx	Western Juxtlahuaca Mixtec
jna	Jangshung
jnd	Jandavra
jng	Yangman
jni	Janji
jnj	Yemsa
jnl	Rawat
jns	Jaunsari
job	Joba
job-x-kivira	Kivira
jod	Wojenaka
jog	Jogi
jos	Jordanian Sign Language
jow	Jowulu
jpa	Jewish Palestinian Aramaic
jpr	הפרסית-יהודית
jqr	Jaqaru
jra	Tiếng Gia Rai
jra-x-golar	Golar
jrb	ערבית יהודית
jrr	Jiru
jrt	Jakattoe
jru	Japrería
jsl	日本手話
jua	Júma
jub	Wannu
juc	Jurchen
jud	Worodougou
juh	Hõne
juk	Wapan
jul	Jirel
jum	Jumjum
jun	Juang
juo	Jiba
jup	Hupdë
jur	Jurúna
jus	Jumla Sign Language
jut	Jutish
juu	Ju
juw	Wãpha
juy	Juray
jv	basa Jawa
jvd	Javindo
jvn	Caribbean Javanese
jwi	Jwira-Pepesa
jya	རྒྱལ་རོང
jye	יהודית-תימנית
jyy	Jaya
ka	ქართული
kaa	Kara-Kalpak
kab	لهجة قبائلية
kab-x-tasahlit	Tasahlit
kac	Kachin
kad	Adara
kaf	卡卓
kag	Kajaman
kah	Kara (Central African Republic)
kai	Karekare
kaj	Jju
kak	Kayapa Kallahan
kak-x-nkalanguya	Northern Kalanguya
kak-x-skalanguya	Southern Kalanguya
kam	Kamba (Kenya)
kan-x-aruvu	Aruvu
kan-x-bavari	Bavari
kan-x-handijog	Handi Jogi
kan-x-jangalu	Jangalu
kan-x-kamashettaru	Kamashettaru
kan-x-kammara	Kammara
kan-x-kannadasl	Kannada Sign Language
kan-x-khacha	Khacha
kan-x-koungaru	Koungaru
kan-x-kudipottila	Kudipottila
kan-x-lambadi	Lambadi (Kannada script)
kan-x-palligaru	Palligaru
kan-x-periya	Periya
kan-x-rate	Rate
kan-x-siddi	Siddi
kan-x-sillekya	Sillekyatha
kan-x-swali	Swali
kan-x-takali	Takalik
kan-x-thigularu	Thigularu
kan-x-waddar	Waddar (Kannada script)
kan-x-yekalavya	Yekalavya
kao	Xaasongaxango
kap	Бежтинский
kaq	Capanahua
kas	कश्मीरी, كشميري‎
kav	Katukína
kaw	Kawi
kax	Kao
kay	Kamayurá
kaz-x-qazaqi	Qazaki
kbb	Kaxuiâna
kbc	Kadiwéu
kbd	къэбэрдеибзэ
kbe	Kanju
kbg	Khamba
kbh	Camsá
kbi	Kaptiau
kbj	Kari
kbk	Grass Koiari
kbk-x-eastkoiari	East Koiari
kbk-x-hogeri	Hogeri
kbk-x-mohi	Mohi
kbk-x-omani	Omani
kbk-x-uberi	Uberi
kbl	Kanembu
kbm	Iwal
kbn	Kare (Central African Republic)
kbo	Keliko
kbp	Kabiyè
kbq	Kamano
kbq-x-kafekofio	Kafe Kofio
kbr	Kafa
kbs	Kande
kbt	Abadi
kbt-x-maura	Gabadi
kbu	Kabutra
kbv	Dera (Indonesia)
kbw	Kaiep
kbx	Ap Ma
kby	Manga Kanuri
kbz	Duhwa
kca	Хантыйский
kca-x-kazim	Khanty Kazim
kca-x-pimskykhanty	Pimsky Khanty
kca-x-tramagan	Tramagan
kcb	Kawacha
kcc	Lubila
kcd	Ngkâlmpw Kanum
kce	Kaivi
kcf	Ukaan
kcg	Tyap
kcg-x-takad	Takad
kch	Vono
kci	Kamantan
kcj	Kobiana
kck	Kalanga
kcl	Kela (Papua New Guinea)
kcm	Gula (Central African Republic)
kcn	Nubi
kcn-KE-nubi	Nubi (Kenya)
kco	Kinalakna
kcp	Kanga
kcq	Kamo
kcr	Katla
kcs	Koenoem
kct	Kaian
kcu	Kami (Tanzania)
kcv	Kete
kcw	Kabwari
kcx	Kachama-Ganjule
kcy	البلبالية
kcz	Konongo
kdc	Kutu
kdd	Yankunytjatjara
kde	Makonde
kdf	Mamusi
kdf-x-aona	Aona
kdf-x-kakuna	Kakuna
kdf-x-kawang	Kawang
kdf-x-mamusisao	Mamusi Sao
kdf-x-pita	Pita
kdf-x-veru	Veru
kdg	Seba
kdh	Tem
kdi	Kumam
kdj	Karamojong
kdk	Numèè
kdl	Tsikimba
kdm	Kagoma
kdn	Kunda
kdp	Kaningdon-Nindem
kdq	Koch
kdr	Karaim
kdt	ภาษากูย
kdt-x-kuayer	Kuay Er
kdt-x-kuaysuai	Kuay Suai
kdt-x-kuaytreu	Kuay Treu
kdt-x-suaychang	Suai chang
kdu	Kadaru
kdw	Koneraw
kdx	Kam
kdy	Keder
kdz	Kwaja
kea	Kabuverdianu
keb	Kélé
kec	Keiga
ked	Kerewe
kee	Eastern Keres
kef	Kpessi
keg	Tese
keh	Keak
kei	Kei
kei-x-besar	Kei Besar
kei-x-kecil	Kei Kecil
kei-x-tanimbar	Tanimbar
kej	Kadar
kek	Kekchí
kel	Kela (Democratic Republic of Congo)
kem	Kemak
ken	Kenyang
keo	Kakwa
kep	Kaikadi
keq	Kamar
ker	Kera
kes	Kugbo
ket	Кетский
keu	Akebu
kev	Kanikkaran
kew	West Kewa
kex	Kukna
key	Kupia
kez	Kukele
kfa	Kodava
kfa-x-korama	Korama
kfb	Northwestern Kolami
kfc	Konda-Dora
kfc-x-kirad	Kirad
kfd	Korra Koraga
kfe	Kota (India)
kff	Koya
kff-x-dmorla	Koya-Dmorla
kff-x-doralakoya	Doralakoya
kff-x-dorli	Dorli Koya
kff-x-gottekoy	Gotte Koya
kff-x-rashak	Rashakoya
kff-x-westgoda	W. Godavari Koya
kfg	Kudiya
kfh	Kurichiya
kfi	Kannada Kurumba
kfi-x-adavkuruba	Adavi Kuruba
kfi-x-kukkekuruba	Kukke Kuruba
kfi-x-kurreeku	Kurre Kurumba
kfi-x-okhl	Okhliya
kfj	克蔑话
kfk	Kinnauri
kfl	Kung
kfm	زبان خوانساری
kfn	Kuk
kfo	Koro (Côte d'Ivoire)
kfp	Korwa
kfq	Korku
kfr	Kachchi
kfs	Bilaspuri
kft	Kanjari
kfu	Katkari
kfv	Kurmukar
kfw	Kharam Naga
kfx	Kullu Pahari
kfx-x-innerser	Inner Seraji
kfx-x-InnerSeraji	Inner Seraji
kfx-x-outerser	Outer Seraji
kfx-x-OuterSeraji	Outer Seraji
kfy	Kumaoni
kfy-x-soriyali	Soriyali
kfz	Koromfé
kfz-x-wkoromf	West Koromfé
kg	Kikongo
kga	Koyaga
kga-x-mangoro	Mangoro
kgb	Kawe
kgc	Kasseng
kgd	Kataang
kge	Komering
kgf	Kube
kgg	Kusunda
kgi	Selangor Sign Language
kgj	खाम
kgk	Kaiwá
kgn	Karingani
kgo	Krongo
kgo-x-krongoabdalla	Krongo Abdalla
kgp	Kaingang
kgq	Kamoro
kgr	Abun
kgr-x-abunji	Abun Ji
kgr-x-abuntat	Abun Tat
kgr-x-madik	Moi Madik
kgs	Kumbainggar
kgt	Somyev
kgu	Kobol
kgv	Karas
kgw	Karon Dori
kgx	Kamaru
kgy	吉隆
kha	Khasi
khb	傣仂語
khb-VN-lue	Lü
khb-x-tailueshan	Tai Lue Shan
khc	Tukang Besi North
khd	Bädi Kanum
khe	Korowai
khf	Khuen
khg	ཁམས་སྐད།
khh	Kehu
khj	Kuturmi
khk	Halh Mongolian
khl	Lusi
khn	Khandesi
kho	Khotanese
khp	Kapori
khq	Koyra Chiini Songhay
khr	Kharia
khs	Kasua
kht	Khamti
khu	Nkhumbi
khv	Хваршинский
khw	کهووار
khx	Kanu
khy	Kele (Democratic Republic of Congo)
khz	Keapara
khz-x-aroma	Aroma
khz-x-babaka	Babaka
khz-x-kalo	Kalo
ki	Gĩkũyũ
kia	Kim
kib	Koalib
kic	Kickapoo
kid	Koshin
kie	Kibet
kif	Eastern Parbate Kham
kig	Kimaama
kih	Kilmeri
kii	Kitsai
kij	Kilivila
kil	Kariya
kim	Тофаларский
kin-x-biofu	Biofu
kin-x-kibingi	Kibingi
kin-x-kijovu	Kijovu
kin-x-kinyabinza	Kinyabinza
kin-x-kinyamulenge	Kinyamulenge
kin-x-rufumbira	Rufumbira
kin-x-twapygmie	Twa Pygmie
kio	Kiowa
kip	Sheshi Kham
kiq	Kosadle
kis	Kis
kit	Agob
kiu	Kirmanjki (individual language)
kiv	Kimbu
kiw	Northeast Kiwai
kiw-x-fomomoto	Fomomoto
kiw-x-gibaio	Gibaio
kiw-x-kaimare	Kaimare
kiw-x-kope	Kope
kix	Khiamniungan Naga
kiy	Kirikiri
kiz	Kisi
kj	Kuanyama
kja	Mlap
kjb	Q'anjob'al
kjc	Coastal Konjo
kjd	Southern Kiwai
kje	Kisar
kjf	Xələc dili
kjg	ກຶມຫມຸ
kjh	Хакасский
kji	Zabana
kjj	Xınalıq dili
kjk	Highland Konjo
kjl	Western Parbate Kham
kjm	Kháng
kjn	Kunjen
kjo	Harijan Kinnauri
kjp	Pwo Eastern Karen
kjq	Western Keres
kjr	Kurudu
kjs	East Kewa
kjs-x-kewacentral	Kewa, Central
kjs-x-kewanorth	Kewa, North
kjt	Phrae Pwo Karen
kju	Kashaya
kjv	Kaikavian Literary Language
kjx	Ramopa
kjy	Erave
kjz	Bumthangkha
kk	қазақ тілі
kka	Kakanda
kkb	Kwerisa
kkc	Odoodee
kkd	Kinuku
kke	Kakabe
kkf	Kalaktang Monpa
kkg	Mabaka Valley Kalinga
kkg-x-kaluwan	Kal-Uwan
kkh	Khün
kki	Kagulu
kkj	Kako
kkk	Kokota
kkl	Kosarek Yale
kkm	Kiong
kkn	Kon Keu
kko	Karko
kkp	Gugubera
kkq	Kaiku
kkq-x-kikubere	Kikubere
kkr	Kir-Balar
kks	Giiwo
kkt	Koi
kku	Tumi
kkv	Kangean
kkw	Teke-Kukuya
kkx	Kohin
kkx-x-pembuang	Pembuang
kky	Guguyimidjir
kkz	Kaska
kl	kalaallisut, kalaallit oqaasii
kla	Klamath-Modoc
klb	Kiliwa
klc	Kolbila
kld	Gamilaraay
kle	कुलुङ (Nepal)
klf	Kendeje
klg	Tagakaulo
klh	Weliki
kli	Kalumpang
kli-x-makki	Makki
klj	زبان خلجی
klk	Kono (Nigeria)
kll	Kagan Kalagan
klm	Migum
klm-x-koyako	Koyako
kln	Kalenjin
klo	Kapya
klp	Kamasa
klq	Rumu
klr	खालिङ
kls	کالاش زبان
klt	Nukna
klu	Klao
klv	Maskelynes
klw	Lindu
klx	Koluwawa
kly	Kalao
klz	Kabola
km	ខ្មែរ, ខេមរភាសា, ភាសាខ្មែរ
kma	Konni
kmb	Kimbundu
kmb-ZM-mbundu	Mbundu
kmc	南侗語
kmd	Majukayang Kalinga
kmd-x-marian	Kalinga of San Mariano Isabela
kme	Bakole
kmf	Kare (Papua New Guinea)
kmg	Kâte
kmh	Kalam
kmi	Kami (Nigeria)
kmj	Kumarbhag Paharia
kmk	Limos Kalinga
kmk-x-biga	Kalinga-Biga
kmk-x-poswoy	Poswoy
kml	Tanudan Kalinga
kml-x-lubo	Lubo
kml-x-marian	Kalingnga of San Mariano Isabela
kml-x-pangul	Pangul
kml-x-taluctoc	Taloctuc
kmm	Kom (India)
kmn	Awtuw
kmo	Kwoma
kmp	Gimme
kmq	Kwama
kmr	Northern Kurdish
kmr-x-afrini	Kurmanji Afrini
kmr-x-shikaki	Shikaki
kms	Kamasau
kmt	Kemtuik
kmu	Kanite
kmv	Karipúna Creole French
kmv-x-kheuol	Kheuol
kmv-x-patua	Patuá
kmw	Komo (Democratic Republic of Congo)
kmw-x-botoki	Botoki
kmw-x-lubuto	Kikumu Lubuto
kmw-x-nyiragongo	Kikumu Nyiragongo
kmw-x-punia	Kikumu Punia
kmw-x-walekale	Kikumu Walekale
kmx	Waboda
kmy	Koma
kmz	زبان ترکی خراسانی
kn	ಕನ್ನಡ
kna	Dera (Nigeria)
kna-x-gasi	Gasi
knb	Lubuagan Kalinga
knb-x-balantoy	Kalinga Balantoy
knb-x-balbal	Kalingan Balbalan
knb-x-balbalasang	Balbalasang
knb-x-ibalatok	Ibalatok
knb-x-karakkad	Karakkad
knb-x-naneng	Kalinga Naneng
knb-x-salegseg	Salegseg Kalinga
knb-x-tobog	Tobog
knb-x-tubo	Kalinga Tubo
knc	Central Kanuri
knd	Konda
kne	Kankanaey
knf	Mankanya
kng	Koongo
kng-x-kilemfu	Kilemfu
kng-x-kindibu	Kindibu
kng-x-kitandu	Kitandu
kni	Kanufi
knj	Western Kanjobal
knk	Kuranko
knl	Keninjal
knl-x-dayakbarai	Dayak Barai
knl-x-dayakgoneh	Dayak Goneh
knl-x-dayakpenyelompa	Dayak Penyelompat
knl-x-dayaksekubin	Dayak Sekubin
knl-x-kebahan	Dayak Kebahan
knl-x-kebahaulak	Dayak Kebahatn Ulak
knl-x-kenyabur	Dayak Kenyabur
knl-x-kenyilu	Dayak Kenyilu
knl-x-kubin	Dayak Kubin
knl-x-kubing	Dayak Kubing
knl-x-ransa	Dayak Ransa
knl-x-ulusekadau	Dayak Ulu Sekadau
knm	Kanamarí
knn	Konkani (individual language)
knn-x-agri	Agri
kno	Kono (Sierra Leone)
knp	Kwanja
knp-x-ndung	Ndung
knq	Kintaq
knr	Kaningra
kns	Kensiu
knt	Panoan Katukína
knu	Kono (Guinea)
knv	Tabo
knw	Kung-Ekoka
knx	Kendayan
kn-x-bajantri	Bajantri
kn-x-bedar	Bedar
kn-x-bhovi	Bhovi
kn-x-budugaja	Buduga Jangam
kn-x-bundebes	Bunde Bestaru
kn-x-chennada	Chenna Dasar
kn-x-cholliva	Chollivala Nayaka
kn-x-devanga	Devanga
kn-x-dombaru	Dombaru
kn-x-dravidar	Dravidar
kn-x-vagri	Vagri
knx-x-ahe	Dayak Kanayate Ahe
knx-x-baajeaje	Be,aje
knx-x-baape	Dayak Baape
knx-x-bajanya	Dayak Bajanya
knx-x-bajare	Dayak Bajare
knx-x-dayakahe	Dayak Ahe
knx-x-dayakmuara	Dayak Muara
knx-x-jawant	Dayak Jawant
knx-x-punangongsolok	Punan Gong Solok
knx-x-redundantahe	Dayak Ahe
kn-x-yalavaru	Yalavaru
kn-x-yeddumar	Yeddumarigi
kny	Kanyok
knz	Kalamsé
ko	한국어, 조선어
koa	Konomala
kod	Kodi
kod-x-gaura	Gaura
koe	Kacipo-Balesi
kof	Kubi
kog	Cogui
koh	Koyo
koi	Коми-пермяцкий
kok	Konkani (macrolanguage)
kol	Kol (Papua New Guinea)
koo	Konzo
kop	Waube
koq	Kota (Gabon)
kos	Kosraean
kot	Lagwan
kou	Koke
kov	Kudu-Camo
kow	Kugama
koy	Koyukon
koz	Korak
koz-x-amako	Amako
kpa	Kutto
kpb	Mullu Kurumba
kpc	Curripaco
kpd	Koba
kpe	Kpelle
kpf	Komba
kpg	Kapingamarangi
kph	Kplang
kpi	Kofei
kpj	Karajá
kpk	Kpan
kpl	Kpala
kpm	Kơho
kpo	Ikposo
kpq	Korupun-Sela
kpr	Korafe-Yegha
kps	Tehit
kps-x-gemna	Gemna
kps-x-kaigar	Kaigar
kps-x-mlafle	Mlafle
kps-x-mlakaya	Mlakaya
kpt	Каратинский
kpu	Kafoa
kpv	Ко́ми-зыря́нский
kpw	Kobon
kpw-x-kou	Kou
kpx	Mountain Koiali
kpy	Корякский
kpz	Kupsabiny
kqa	Mum
kqa-x-kandiki	Kandiki
kqa-x-madulap	Madulap
kqa-x-mamamokan	Mamamokan
kqb	Kovai
kqc	Doromu-Koki
kqd	ܣܘܪܬ
kqe	Kalagan
kqf	Kakabai
kqg	Khe
kqh	Kisankasa
kqi	Koita Ga
kqj	Koromira
kqk	Kotafon Gbe
kql	Kyenele
kqm	Khisa
kqn	Kaonde
kqn-x-lubango	Lubango
kqo	Eastern Krahn
kqp	Kimré
kqq	Krenak
kqr	Kimaragang
kqr-x-sandayo	Sandayo
kqr-x-sonsogon	Sonsogon
kqs	Northern Kissi
kqt	Klias River Kadazan
kqv	Okolod
kqw	Kandas
kqx	Mser
kqy	Koorete
kqz	Korana
kr	Kanuri
kra	Kumhali
krb	Karkin
krc	Карачаево-балкарский
krd	Kairui-Midiki
kre	Panará
krf	Koro (Vanuatu)
krh	Kurama
kri	Krio
krj	Kinaray-A
krk	Керекский
krl	Карельский
krm	Krim
krn	Sapo
krp	Korop
krr	Kru'ng 2
krr-x-lun	Lun
krs	Gbaya
krt	Tumari Kanuri
kru	Kurukh
kru-x-shaddri	Shaddri Uraw
krv	Kavet
krw	Western Krahn
krx	Karon
kry	Qrız dili
krz	Sota Kanum
ksa	Shuwa-Zamani
ksb	Shambala
ksc	Southern Kalinga
ksc-x-isumadel	Isumadel
ksc-x-tulgao	Kalinga Tulgao
ksc-x-tulgo	Kalinga Tulgo
ksd	Kuanua
kse	Kuni
ksf	Bafia
ksg	Kusaghe
ksh	Kölsch
ksi	Krisa
ksj	Uare
ksk	Kansa
ksl	Kumalu
ksm	Kumba
ksn	Kasiguranin
kso	Kofa
ksp	Kaba
ksq	Kwaami
ksr	Borong
kss	Southern Kisi
kss-x-southkissi	Southern Kissi
kst	Winyé
ksu	Khamyang
ksu-x-shyam	Shyam
ksv	Kusu
ksw	S'gaw Karen
ksx	Kedang
ksy	Kharia Thar
ksz	Kodaku
kta	Katua
ktb	Kambaata
ktc	Kholok
ktd	Kokata
kte	Nubri
ktf	Kwami
kth	Karanga
kti	North Muyu
ktj	Plapo Krumen
ktl	کوروشی
ktm	Kurti
ktn	Karitiâna
kto	Kuot
ktp	卡多
ktr	Kota Marudu Tinagas
kts	South Muyu
ktt	Ketum
ktu	Kituba (Democratic Republic of Congo)
ktu-x-kimboma	Kimboma
ktu-x-kiyaleta	Kikongo ya leta
ktv	Eastern Katu
ktw	Kato
ktx	Kaxararí
kty	Kango (Bas-Uélé District)
ktz	Ju/'hoan
ku	Kurdî, كوردی‎
kub	Kutep
kuc	Kwinsu
kud	'Auhelawa
kue	Kuman (Papua New Guinea)
kue-x-bari	Bari
kue-x-kakondo	Kakondo
kue-x-koro	Koro
kue-x-segega	Segega
kuf	Western Katu
kug	Kupa
kuh	Kushi
kui	Kuikúro-Kalapálo
kuj	Kuria
kuk	Kepo'
kul	Kulere
kum	Кумыкский
kun	Kunama
kuo	Kumukio
kup	Gunimaipa
kup-x-eromsai	Erom Sai
kup-x-eromtaira	Erom Taira
kup-x-karuama	Karuama
kuq	Karipuna
kus	Kusaal
kut	Kutenai
kuu	Upper Kuskokwim
kuv	Kur
kuw	Kpagua
kux	Kukatja
kuy	Kuuku-Ya'u
kuz	Kunza
kv	коми кыв
kva	Багвалинский
kvb	Kubu
kvc	Kove
kvd	Kui (Indonesia)
kve	Kalabakan
kvf	Kabalai
kvg	Kuni-Boazi
kvh	Komodo
kvi	Kwang
kvj	Psikye
kvk	Korean Sign Language
kvl	Kayaw
kvm	Kendem
kvn	Border Kuna
kvo	Dobel
kvp	Kompane
kvq	Geba Karen
kvr	Kerinci
kvr-x-talangmamak	Talang Mamak
kvs	Kunggara
kvt	Lahta Karen
kvu	Yinbaw Karen
kvv	Kola
kvw	Wersing
kvx	Parkari Koli
kvy	Yintale Karen
kvz	Tsakwambo
kw	Kernewek
kwa	Dâw
kwb	Kwa
kwc	Likwala
kwd	Kwaio
kwe	Kwerba
kwf	Kwara'ae
kwg	Sara Kaba Deme
kwh	Kowiai
kwi	Awa-Cuaiquer
kwj	Kwanga
kwk	Kwakiutl
kwl	Kofyar
kwl-x-jipal	Jipal
kwm	Kwambi
kwn	Kwangali
kwn-BW-kwangali	Kwangali
kwo	Kwomtari
kwp	Kodia
kwr	Kwer
kws	Kwese
kwt	Kwesten
kwu	Kwakum
kwv	Sara Kaba Náà
kww	Kwinti
kwx	Khirwar
kwy	San Salvador Kongo
kxa	Kairiru
kxb	Krobu
kxc	Konso
kxd	Brunei
kxf	Manumanaw Karen
kxh	Karo (Ethiopia)
kxi	Keningau Murut
kxj	Kulfa
kxk	Zayein Karen
kxl	कुड़ुख़
kxm	Northern Khmer
kxn	Kanowit-Tanjong Melanau
kxo	Kanoé
kxp	Wadiyara Koli
kxq	Smärky Kanum
kxr	Koro (Papua New Guinea)
kxs	康家语
kxt	Koiwat
kxu	Kui (India)
kxv	Kuvi
kxw	Konai
kxx	Likuba
kxy	Kayong
kxz	Kerewo
ky	Кыргызча, Кыргыз тили
kya	Kwaya
kya-x-ruri	Ruri
kyb	Butbut Kalinga
kyc	Kyaka
kyd	Karey
kye	Krache
kyf	Kouya
kyg	Keyagana
kyh	Karok
kyi	Kiput
kyj	Karao
kyk	Kamayo
kyk-x-cortesanon	Cortesanon
kyk-x-tagonon	Tagon-on
kym	Kpatili
kyn	Northern Binukidnon
kyo	Kelon
kyp	Kang
kyq	Kenga
kyr	Kuruáya
kys	Baram Kayan
kyt	Kayagar
kyu	Western Kayah
kyv	Kayort
kyw	Kudmali
kyx	Rapoisi
kyy	Kambaira
kyz	Kayabí
kza	Western Karaboro
kzb	Kaibobo
kzc	Bondoukou Kulango
kzd	Kadai
kze	Kosena
kzf	Da'a Kaili
kzg	しまゆみた
kzi	Kelabit
kzj	Coastal Kadazan
kzl	Kayeli
kzm	Kais
kzn	Kokola
kzo	Kaningi
kzp	Kaidipang
kzp-x-bolangitan	Bolangitan
kzq	Kaike
kzr	Karang
kzs	Sugut Dusun
kzt	Tambunan Dusun
kzu	Kayupulau
kzv	Komyandaret
kzw	Karirí-Xocó
kzx	Kamarian
kzy	Kango (Tshopo District)
kzz	Kalabra
la	latine, lingua latina
laa	Southern Subanen
lab	Linear A
lac	Lacandon
lad	Ladino
lae	Pattani
laf	Lafofa
lag	Langi
lah	Lahnda
lai	Lambya
lai-x-bandya	Bandya
laj	Lango (Uganda)
lak	Laka (Nigeria)
lal	Lalia
lam	Lamba
lan	Laru
lao-x-laonhook	Lao Nhook
lao-x-laotiene	Lao tiene
lao-x-vientiane	Lao-Vientiane
lap	Laka (Chad)
laq	Qabiao
lar	Larteh
las	Lama (Togo)
lau	Laba
law	Lauje
lax	Tiwa
lay	Lama Bai
lb	Lëtzebuergesch
lbb	Label
lbc	拉珈语
lbe	Лакский
lbf	Tinani
lbg	Laopang
lbi	La'bi
lbj	Ladakhi
lbk	Central Bontok
lbl	Libon Bikol
lbm	Lodhi
lbn	Lamet
lbo	Laven
lbo-x-champasak	Laven Champasak
lbo-x-lavenxekon	Laven Xekong
lbq	Wampar
lbr	Lohorung
lbs	لغة الإشارة الليبية
lbt	Lachi
lbu	Labu
lbv	Lavatbura-Lamusong
lbw	Tolaki
lbx	Lawangan
lbx-x-bantian	Dayak Bantian
lbx-x-capuracu	Capur Acu
lbx-x-dayakbenua	Dayak Benua
lbx-x-dayakpasir	Dayak Pasir
lbx-x-dayakpaus	Dayak Paus
lbx-x-lomgbenuang	Long Benuang
lbx-x-mantarapkabut	Dayak Mantarap Kabut
lby	Lamu-Lamu
lbz	Lardil
lcc	Legenyem
lcd	Lola
lce	Loncong
lcf	Lubu
lch	Luchazi
lch-ZM-luchazi	Luchazi
lcl	Lisela
lcm	Tungag
lcp	Western Lawa
lcq	Luhu
lcs	Lisabata-Nuniali
lda	Kla-Dan
ldb	Dũya
ldg	Lenyima
ldh	Lamja-Dengsa-Tola
ldi	Laari
ldj	Lemoro
ldk	Leelau
ldl	Kããn
ldm	Landoma
ldn	Láadan
ldo	Loo
ldp	Tso
ldp-x-chobbo	Chobbo
ldq	Lufu
lea	Lega-Shabunda
leb	Lala-Bisa
leb-x-lala	Lala
leb-x-mbo	Mbo
leb-x-swaka	Swaka
lec	Leco
led	Lendu
lee	Lyélé
lef	Lelemi
leh	Lenje
lei	Lemio
lej	Lengola
lek	Leipon
lel	Lele (Democratic Republic of Congo)
lem	Nomaande
len	Lenca
leo	Leti (Cameroon)
lep	Lepcha
leq	Lembena
ler	Lenkau
les	Lese
let	Lesing-Gelimi
leu	Kara (Papua New Guinea)
lev	Lamma
lew	Ledo Kaili
lex	Luang
ley	Lemolang
lez	Лезгинский
lfa	Lefa
lfn	Lingua Franca Nova
lg	Luganda
lga	Lungga
lgb	Laghu
lgg	Lugbara
lgh	Laghuu
lgi	Lengilu
lgk	Lingarak
lgl	Wala
lgm	Lega-Mwenga
lgm-x-kinangozi	Kinangozi
lgm-x-kirega	Kirega
lgn	Opuuo
lgq	Logba
lgr	Lengo
lgt	Pahi
lgu	Longgu
lgw	Lougwau
lgz	Ligenza
lha	Laha (Viet Nam)
lhh	Laha (Indonesia)
lhi	拉祜西语
lhl	Lahul Lohar
lhm	ल्होमी
lhn	Lahanan
lhp	Lhokpu
lht	Lo-Toga
lhu	拉祜语
lhu-x-redlahu	Red Lahu
li	Limburgs
lia	West-Central Limba
lib	Likum
lic	黎语
lic-x-runli	Run Li
lid	Nyindrou
lie	Likila
lif	लिम्बू
lig	Ligbi
lih	Lihir
lij	Ligurian
lik	Lika
lil	Lillooet
lin-x-linmilitar	Military Lingala
lio	Liki
lip	Sekpele
liq	Libido
lir	Liberian English
lis	傈僳语
lis-x-hualisu	Hua Lisu
lis-x-xiaxia	Xia Xia
liu	Logorik
liu-x-logori	Logori
liu-x-saburi	Saburi
liv	Liv
liw	Col
liw-x-lembak	Lembak Delapan
lix	Liabuku
liy	Banda-Bambari
liz	Libinza
lje	Rampi
lji	Laiyolo
ljl	Li'o
ljp	Lampung Api
ljp-x-lampungpesisir	Lampung Pesisir
ljw	Yirandali
lka	Lakalei
lkb	Kabras
lkc	Kucong
lkd	Lakondê
lke	Kenyi
lkh	Lakha
lki	لەکی
lkj	Remun
lkl	Laeko-Libuat
lkn	Lakon
lko	Khayo
lkr	Päri
lks	Kisa
lkt	Lakota
lky	Lokoya
lla	Lala-Roba
llb	Lolo
llc	Lele (Guinea)
lld	Ladin
lle	Lele (Papua New Guinea)
llg	Lole
llg-x-kolobolon	Kolobolon
llh	Lamu
lli	Teke-Laali
lll	Lilau
llm	Lasalimu
lln	Lele (Chad)
llo	Khlor
llp	North Efate
llp-x-buninga	Buninga
llp-x-emau	Emau
llp-x-nguna	Nguna
llp-x-paunagisu	Paunagisu
llq	Lolak
lls	Lithuanian Sign Language
llu	Lau
llu-x-ndai	Ndai
llu-x-suafa	Suafa
llx	Lauan
lma	East Limba
lmb	Merei
lmd	Lumun
lme	Pévé
lmf	South Lembata
lmg	Lamogai
lmh	Lambichhong
lmi	Lombi
lmj	West Lembata
lmj-x-lembeleape	Lembata Eleape
lmk	Lamkang
lml	Hano
lmn	Lambadi
lmn-x-anjara	Anjara
lmn-x-gormati	Gormati
lmo	Lombard
lmp	Limbum
lmq	Lamatuka
lmr	Lamalera
lmu	Lamenu
lmv	Lomaiviti
lmv-x-levuka	Levuka
lmw	Lake Miwok
lmx	Laimbue
lmy	Lamboya
lmz	Lumbee
ln	Lingála
lna	Langbashe
lnb	Mbalanhu
lnd	Lundayeh
lnd-x-dayaktabun	Dayak Tabun
lnd-x-pabawan	Lundayeh Pa'bawan
lng	Langobardic
lnh	Lanoh
lni	Daantanai'
lnl	South Central Banda
lnm	Langam
lnn	Lorediakarkar
lno	Lango (Sudan)
lno-x-okolie	Okolie
lns	Lamnso'
lnu	Longuda
lnz	Lonzo
lnz-x-kilonzo	Kilonzo
lo	ພາສາລາວ
loa	Loloda
lob	Lobi
loc	Inonhan
loe	Saluan
loe-x-saluanboloa	Saluan Boloa
lof	Logol
log	Logo
loh	Narim
loi	Loma (Côte d'Ivoire)
loj	Lou
lok	Loko
lol	Mongo-Lotwa
lol-x-besongo	Besongo
lol-x-bilangi	Bilangi
lol-x-boangi	Boangi
lol-x-bokatola	Bokatola
lol-x-booli	Booli
lol-x-bukala	Bukala
lol-x-emoma	Emoma
lol-x-ikongo	Ikongo
lol-x-iyembe	Iyembe
lol-x-langondjo	Langondjo
lol-x-lionje	Lionje
lol-x-lokatoladeduali	Lokatola de Duali
lol-x-lokonda	Lokonda
lol-x-lokulnua	Lokolnua
lol-x-londjolo	Londjolo
lol-x-longo	Longo
lol-x-longombe	Longombe
lol-x-lontomba	Lontomba
lol-x-losanga	Losanga
lol-x-lotswano	Lotswa North
lol-x-lotswaso	Lotswa South
lol-x-lotunube	Lotunube
lol-x-lotwanor	Mongo-Lotwa North
lol-x-lotwasou	Mongo-Lotwa South
lol-x-loubala	Loubala
lom	Loma (Liberia)
lon	Malawi Lomwe
loo	Lombo
lop	Lopa
loq	Lobala
loq-x-likoka	Likoka
loq-x-lokoka	Lokoka
lor	Téén
los	Loniu
lot	Otuho
lou	Louisiana Creole French
lov	水田
low	Tampias Lobu
loy	ल्होवा
loz	Lozi
lpa	Lelepa
lpe	Lepki
lpn	Long Phuri Naga
lpo	里泼
lpx	Lopit
lra	Rara Bakati'
lra-x-dayaksuruh	Dayak Suruh
lrc	لُری
lre	Laurentian
lrg	Laragia
lri	Marachi
lrk	Loarki
lrl	اچمی
lrm	Marama
lrn	Lorang
lro	Laro
lrr	Southern Yamphu
lrt	Larantuka Malay
lrv	Larevat
lrz	Lemerig
lsa	Lasgerdi
lsb	Burundian Sign Language
lsd	לשנא דני
lse	Lusengo
lsg	Lyons Sign Language
lsh	Lish
lsi	Lashi
lsl	Latvian Sign Language
lsm	Saamia
lsm-x-lugwe	Lugwe
lso	Laos Sign Language
lsp	Panamanian Sign Language
lsr	Aruop
lss	Lasi
lst	Trinidad and Tobago Sign Language
lsy	Mauritian Sign Language
lt	lietuvių kalba
ltc	Late Middle Chinese
ltg	Latgalian
lti	Leti (Indonesia)
ltn	Latundê
lto	Tsotso
lts	Tachoni
ltu	Latu
lu	Tshiluba
lua	Luba-Lulua
luc	Aringa
lud	Людиковское наречие
lue	Luvale
lui	Luiseno
luj	Luna
luk	Lunanakha
lul	Olu'bo
lum	Luimbi
lun	Lunda
lun-x-lundakoosa	Lunda Koosa
luo	Luo (Kenya and Tanzania)
luo-x-lusonga	Lusonga
lup	Lumbu
luq	Lucumi
lur	Laura
lus	Lushai
lut	Lushootseed
luu	Lumba-Yakkha
luv	Luwati
luw	Luo (Cameroon)
luy	Luyia
luz	لُری
lv	latviešu valoda
lva	Maku'a
lvk	Lavukaleve
lvs	Standard Latvian
lvu	Levuka
lwa	Lwalu
lwe	Lewo Eleng
lwg	Wanga
lwh	White Lachi
lwl	ภาษาเลอเวือะตะวันออก
lwm	Laomian
lwo	Luwo
lws	Malawian Sign Language
lwt	Lewotobi
lwu	Lawu
lww	Lewo
lya	Layakha
lyg	Lyngngam
lyn	Luyana
lzh	Literary Chinese
lzl	Litzlitz
lzn	Leinong Naga
lzz	Laz
maa	San Jerónimo Tecóatl Mazatec
mab	Yutanduchi Mixtec
mad	Madurese
mae	Bo-Rukul
maf	Mafa
mag	Magahi
mai	Maithili
mai-x-bajjika	Bajjika
mai-x-dehati	Dehati Bhojouri
mai-x-thethi	Thethi
maj	Jalapa De Díaz Mazatec
mak	Makasar
mam	Mam
man	Mandingo
maq	Chiquihuitlán Mazatec
mar-x-ghondali	Gondhali
mar-x-junu	Junu Marathi
mar-x-kokani	Kokani
mar-x-kothli	Kothli
mar-x-maratha	Maratha/Beda
mar-x-mayalamarat	Mayalamarathian
mar-x-tadvi	Tadvi
mas	Masai
mas-x-	Dorobo
mat	San Francisco Matlatzinca
mau	Huautla Mazatec
mav	Sateré-Mawé
maw	Mampruli
max	North Moluccan Malay
maz	Central Mazahua
mba	Higaonon
mbb	Western Bukidnon Manobo
mbb-x-arumanen	Arumanen
mbb-x-kiriyenteken	Kiriyenteken
mbb-x-pulangiyan	Pulangiyen
mbb-x-pulangiyen	Manobo Pulangiyen
mbc	Macushi
mbd	Dibabawon Manobo
mbf	Baba Malay
mbh	Mangseng
mbh-x-kukura	Kukura
mbh-x-kupi	Kupi
mbh-x-marapu	Oraini
mbi	Ilianen Manobo
mbj	Nadëb
mbk	Malol
mbl	Maxakalí
mbm	Ombamba
mbn	Macaguán
mbo	Mbo (Cameroon)
mbp	Malayo
mbq	Maisin
mbq-x-abiosoveaki	Abiosoveaki
mbq-x-gauga	Gauga
mbq-x-kosira	Kosira
mbr	Nukak Makú
mbs	Sarangani Manobo
mbs-x-piyabawa	Piyabawa Manobo
mbt	Tigwa, Tigwahanen
mbt-x-kulamanen	Kulamanen
mbt-x-tigwa	Tigwa, Tigwahanen
mbt-x-tingod	Tala Ingod Manobo
mbu	Mbula-Bwazza
mbv	Mbulungish
mbw	Maring
mbx	Mari (East Sepik Province)
mby	Memoni
mbz	Amoltepec Mixtec
mca	Maca
mcb	Machiguenga
mcc	Bitur
mcd	Sharanahua
mce	Itundujia Mixtec
mcf	Matsés
mcg	Mapoyo
mch	Dhe'cwana
mci	Mese
mcj	Mvanip
mck	Mbunda
mck-ZM-mbunda	Mbunda
mcl	Macaguaje
mcm	Malaccan Creole Portuguese
mcn	Masana
mco	Coatlán Mixe
mcp	Makaa
mcq	Ese
mcq-x-akabafa	Akabafa
mcq-x-oikol	Oikol
mcr	Menya
mcs	Mambai
mct	Mengisa
mcu	Cameroon Mambila
mcu-x-miniwa	Miniwa
mcu-x-ndeba	Ndeba
mcu-x-tong	Tong
mcv	Minanibai
mcw	Mawa (Chad)
mcx	Mpiemo
mcy	South Watut
mcz	Mawan
mda	Mada (Nigeria)
mdb	Morigi
mdc	Male (Papua New Guinea)
mdc-x-kaliku	Kaliku
mdd	Mbum
mde	Maba (Chad)
mdf	Мокшанский
mdg	Masalit
mdh	Maguindanaon
mdh-x-dananao	Dananao
mdi	Mamvu
mdj	Mangbetu
mdj-x-	Malele
mdj-x-medje	Medje
mdk	Mangbutu
mdl	Maltese Sign Language
mdm	Mayogo
mdn	Mbati
mdp	Mbala
mdq	Mbole
mdr	Mandar
mds	Maria (Papua New Guinea)
mdt	Mbere
mdu	Mboko
mdv	Santa Lucía Monteverde Mixtec
mdw	Mbosi
mdx	Dizin
mdy	Male (Ethiopia)
mdz	Suruí Do Pará
mea	Menka
meb	Ikobi
mec	Mara
med	Melpa
mee	Mengen
mef	Megam
meh	Southwestern Tlaxiaco Mixtec
mei	Midob
mej	Meyah
mek	Mekeo
mek-x-inafangan	Inanfangan
mek-x-nmekioupst	North Mekio Upstream
mek-x-northmekeo	North Mekeo
mel	Central Melanau
mem	Mangala
men	Mende (Sierra Leone)
meo	Kedah Malay
mep	Miriwung
meq	Merey
mer	Meru
mes	Masmaje
met	Mato
meu	Motu Elevala
mev	Mano
mew	Maaka
mey	حسانية
mey-MA-hassaniya	Hassaniya (Morocco)
mey-MR-hassaniya	Hassaniya (Mauritania)
mey-NE-hassaniya	Hassaniya (Niger)
mey-SN-hassaniya	Hassaniya (Senegal)
mez	Menominee
mfa	Pattani Malay
mfb	Bangka
mfc	Mba
mfd	Mendankwe-Nkwen
mfe	Morisyen
mff	Naki
mfg	Mogofin
mfh	Matal
mfi	Wandala
mfj	Mefele
mfk	North Mofu
mfl	Putai
mfm	Marghi South
mfn	Cross River Mbembe
mfo	Mbe
mfp	Makassar Malay
mfq	Moba
mfq-x-mual	Mual
mfr	Marithiel
mfs	Mexican Sign Language
mft	Mokerang
mfu	Mbwela
mfv	Mandjak
mfx	Melo
mfy	Mayo
mfz	Mabaan
mg	fiteny malagasy
mga	Middle Irish (900-1200)
mgb	Mararit
mgc	Morokodo
mgc-x-bitti	Bitti
mgd	Moru
mge	Mango
mgf	Maklew
mgg	Mpumpong
mgg-x-kunabembe	Kunabembe
mgg-x-mpoman	Mpoman
mgh	Makhuwa-Meetto
mgi	Lijili
mgj	Abureni
mgk	Mawes
mgl	Maleu
mgl-x-gaulapua	Gaulapua
mgl-x-kilenge	Kilenge
mgl-x-somate	Somate
mgm	Mambae
mgn	Mbangi
mgo	Meta'
mgp	Eastern Magar
mgq	Malila
mgr	Mambwe-Lungu
mgr-MW-chimambwe	Chimambwe
mgs	Manda
mgt	Mongol
mgu	Mailu
mgu-x-derebai	Derebai
mgv	Matengo
mgw	Matumbi
mgy	Mbunga
mgz	Mbugwe
mh	Kajin M̧ajeļ
mha	Manda (India)
mhb	Mahongwe
mhc	Mocho
mhd	Mbugu
mhe	Besisi
mhf	Mamaa
mhg	Margu
mhi	Ma'di
mhi-x-burolo	Burolo
mhj	Mogholi
mhk	Mungaka
mhl	Mauwake
mhl-x-alesuwaw	Alesuwaw
mhl-x-bedup	Bedup
mhl-x-mawak	Mawak
mhl-x-mewok	Mewok
mhl-x-ulatapun	Ulatapun
mhm	Makhuwa-Moniga
mhn	Mócheno
mho	Mashi (Zambia)
mhp	Balinese Malay
mhq	Mandan
mhr	Восточный Марийский
mhs	Buru (Indonesia)
mht	Mandahuaca
mhu	Digaro-Mishmi
mhw	Mbukushu
mhw-x-mbukunamib	Mbukushu (Namibia)
mhw-x-mbukurundu	Mbukushu (Rundu)
mhx	Lhao Vo
mhy	Ma'anyan
mhy-x-balangan	Balangan
mhy-x-benualima	Dayak Ma'anyan Banua Lima
mhy-x-halong	Dayak Halong
mhy-x-pajusapulu	Paju Sapuluh
mhy-x-samihim	Samihim
mhz	Mor (Mor Islands)
mi	te reo Māori
mia	Miami
mib	Atatláhuca Mixtec
mic	Mi'kmaq
mid	رطنة
mie	Ocotepec Mixtec
mif	Mofu-Gudur
mig	San Miguel El Grande Mixtec
mih	Chayuco Mixtec
mii	Chigmecatitlán Mixtec
mij	Abar
mik	Mikasuki
mil	Peñoles Mixtec
mim	Alacatlatzala Mixtec
min	Minangkabau
mio	Pinotepa Nacional Mixtec
mip	Apasco-Apoala Mixtec
miq	Mískito
miq-HN-miskito	Miskito
mir	Isthmus Mixe
mis	Uncoded languages
mit	Southern Puebla Mixtec
miu	Cacaloxtepec Mixtec
miw	Akoye
mix	Mixtepec Mixtec
miy	Ayutla Mixtec
miz	Coatzospan Mixtec
mjc	San Juan Colorado Mixtec
mjd	Northwest Maidu
mjg	土族语
mjh	Mwera
mji	金门方言
mji-x-daoaodai	Dao Ao Dai
mji-x-daotuyen	Dao Tuyen
mji-x-lanten	Lanten
mjj	Mawak
mjk	Matukar
mjl	Mandeali
mjm	Medebur
mjn	Ma (Papua New Guinea)
mjo	Malankuravan
mjp	Malapandaram
mjq	Malaryan
mjr	Malavedan
mjs	Miship
mjt	Sauria Paharia
mju	Manna-Dora
mjv	Mannan
mjw	Karbi
mjx	Mahali
mjy	Mahican
mjz	Majhi
mk	македонски јазик
mka	Mbre
mkb	Mal Paharia
mkb-beng-malpaharia	Malpaharia
mkc	Siliput
mke	Mawchi
mke-x-vahudhi	Vahudhi
mkf	Miya
mkg	莫语 (China)
mki	ڌڪتي
mkj	Mokilese
mkk	Byep
mkl	Mokole
mkm	Moklen
mkn	Kupang Malay
mkn-x-lamankira	Timur Lamankira
mkn-x-timurkupan	Timur Kupang
mko	Mingang Doso
mkp	Moikodi
mkp-x-doriri	Doriri
mkq	Bay Miwok
mkr	Malas
mkr-x-simbukanam	Simbukanam
mks	Silacayoapan Mixtec
mkt	Vamale
mku	Konyanka Maninka
mkv	Mafea
mkw	Kituba (Congo)
mkx	Kinamiging Manobo
mky	East Makian
mkz	Makasae
ml	മലയാളം
mla	Malo
mlb	Mbule
mlc	Cao Lan
mle	Manambu
mlf	Mal
mlh	Mape
mli	Malimpung
mlj	Miltu
mlk	Ilwana
mll	Malua Bay
mlm	仫佬
mln	Malango
mlo	Mlomp
mlp	Bargam
mlp-x-amse	Amse
mlp-x-anahwag	Anahwag
mlp-x-bunu	Bunu
mlp-x-ezaqham	Ezaq-ham
mlp-x-gabagsal	Gabagsal
mlp-x-kurum	Kurum
mlp-x-niyau	Niyau
mlp-x-selelai	Selelai
mlp-x-wasabamal	Wasabamal
mlq	Western Maninkakan
mlr	Vame
mls	Masalit
mlu	To'abaita
mlv	Motlav
mlw	Moloko
mlx	Malfaxal
mlz	Malaynon
mma	Mama
mmb	Momina
mmc	Michoacán Mazahua
mmd	毛南语
mme	Mae
mme-x-nsmllnambas	North Small Nambas
mmf	Mundat
mmg	North Ambrym
mmh	Mehináku
mmi	Musar
mmj	Majhwar
mmk	Mukha-Dora
mml	克蔑话
mmm	Maii
mmn	Mamanwa
mmo	Mangga Buang
mmp	Siawi
mmq	Musak
mmq-x-amule	Amule
mmq-x-gariskang	Gariskang
mmq-x-icvieng	Icvieng
mmr	西部次方言
mmt	Malalamai
mmu	Mmaala
mmv	Miriti
mmw	Emae
mmx	Madak
mmy	Migaama
mmz	Mabaale
mn	Монгол хэл
mna	Mbula
mnb	Muna
mnc	满语
mnd	Mondé
mne	Naba
mnf	Mundani
mng	Eastern Mnong
mnh	Mono (Democratic Republic of Congo)
mni	Manipuri
mni-x-kakching	Kakching
mni-x-kwatha	Kwatha
mni-x-pangal	Pangal
mni-x-sekmai	Sekmai
mnj	Munji
mnk	Mandinka
mnl	Tiale
mnl-x-kemea	Kemea
mnm	Mapena
mnn	Southern Mnong
mnp	闽北
mnq	Minriq
mnr	Mono (USA)
mns	Мансийский
mnu	Mer
mnu-x-gua	Gua
mnu-x-juabeta	Juabeta
mnv	Rennell-Bellona
mnw	Mon
mnx	Manikion
mny	Manyawa
mnz	Moni
moa	Mwan
moc	Mocoví
mod	Mobilian
moe	Montagnais
mog	Mongondow
mog-x-boroko	Boroko
moh	Mohawk
moi	Mboi
moj	Monzombo
mok	Morori
mom	Mangue
moo	Monom
mop	Mopán Maya
moq	Mor (Bomberai Peninsula)
mor	Moro
mos	Mossi
mot	Barí
mot-VE-bari	Bari
mou	Mogum
mov	Mohave
mow	Moi (Congo)
mox	Molima
moy	Shekkacho
moz	Mokilko
mpa	Mpoto
mpb	Mullukmulluk
mpc	Mangarayi
mpd	Machinere
mpe	Majang
mpg	Marba
mph	Maung
mpi	Mpade
mpj	Martu Wangka
mpk	Mbara (Chad)
mpl	Middle Watut
mpm	Yosondúa Mixtec
mpn	Mindiri
mpo	Miu
mpp	Migabac
mpq	Matís
mpr	Vangunu
mpr-x-bareke	Bareke
mps	Dadibi
mpt	Mian
mpu	Makuráp
mpv	Mungkip
mpw	Mapidian
mpx	Misima-Panaeati
mpz	Mpi
mqa	Maba (Indonesia)
mqb	Mbuko
mqc	Mangole
mqe	Matepi
mqf	Momuna
mqf-x-intamaya	Intamaya
mqg	Kota Bangun Kutai Malay
mqh	Tlazoyaltepec Mixtec
mqi	Mariri
mqj	Mamasa
mqj-x-batanguru	Batanguru
mqj-x-nosu	Nosu
mqj-x-ulusalu	Ulusalu
mqk	Rajah Kabunsuwan Manobo
mql	Mbelime
mqm	South Marquesan
mqn	Moronene
mqo	Modole
mqp	Manipa
mqq	Minokok
mqr	Mander
mqs	West Makian
mqt	ภาษาม๊อก
mqu	Mandari
mqv	Mosimo
mqw	Murupi
mqw-x-haimo	Haimo
mqx	Mamuju
mqy	Manggarai
mqz	Pano
mr	मराठी
mra	ภาษามลาบรี
mrb	Marino
mrc	Maricopa
mrd	Western Magar
mre	Martha's Vineyard Sign Language
mrf	Elseng
mrg	Mising
mrh	Mara Chin
mrj	Кырык мары
mrk	Hmwaveke
mrl	Mortlockese
mrm	Merlav
mrn	Cheke Holo
mro	Mru
mro-BD-mruchowlai	Mruchow lai
mrp	Morouas
mrq	North Marquesan
mrr	Maria (India)
mrs	Maragus
mrt	Marghi Central
mru	Mono (Cameroon)
mrv	Mangareva
mrw	Maranao
mrx	Maremgi
mr-x-nagpuri	Nagpuri Marathi
mry	Mandaya
mry-x-manay	Manay
mry-x-mandcaraga	Mandaya Caraga
mry-x-uppermanay	Upper Manay
mrz	Marind
mrz-x-lahukmarind	Marind Lahuk
ms	bahasa Melayu, بهاس ملايو‎
msb	Masbatenyo
msc	Sankaran Maninka
msd	Yucatec Maya Sign Language
mse	Musey
msf	Mekwei
msg	Moraid
msh	Masikoro Malagasy
msi	Sabah Malay
msj	Ma (Democratic Republic of Congo)
msk	Mansaka
msl	Molof
msm	Agusan Manobo
msm-x-behoonmano	Behoon Manobo
msm-x-bunawan	Agusanen - Bunawan
msm-x-bunawanon	Bunawanon
msm-x-lapaknon	Lapaknon Manobo
msm-x-loreto	Agusanen - Loreto
msm-x-manguangan	Manguangan
msm-x-pangyan	Pangyan
msm-x-talacogon	Talacogon
msm-x-umayam	Umayam
msm-x-umayamno	Umayamnon
msm-x-wawaanon	Manobo Wawaanon
msn	Vurës
mso	Mombum
msq	Caac
msr	Mongolian Sign Language
mss	West Masela
msu	Musom
msv	Maslam
msw	Mansoanka
msx	Moresada
ms-x-dcv	bahasa Melayu - Dominant Culture Variant
msy	Aruamu
msy-x-tuga	Tuga
msz	Momare
mt	Malti
mta	Cotabato Manobo
mta-x-sulitmanob	Sulit Manobo
mta-x-tasaday	Tasaday
mtb	Anyin Morofo
mtc	Munit
mtd	Mualang
mte	Mono (Solomon Islands)
mtf	Murik (Papua New Guinea)
mtg	Una
mth	Munggui
mti	Maiwa (Papua New Guinea)
mti-x-mawaenage	Mawae Nage
mtj	Moskona
mtk	Mbe'
mtl	Montol
mtm	Mator
mtn	Matagalpa
mto	Totontepec Mixe
mtp	Wichí Lhamtés Nocten
mtq	Tiếng Mường
mtr	Mewari
mts	Yora
mtt	Mota
mtu	Tututepec Mixtec
mtv	Asaro'o
mtw	Southern Binukidnon
mtx	Tidaá Mixtec
mty	Nabi
mua	Mundang
mub	Mubi
muc	Ajumbu
mud	Алеутско-медновский
mue	Media Lengua
mug	Musgu
muh	Mündü
mui	Musi
mui-x-penesak	Penesak
muj	Mabire
muk	Mugom
mul	Multiple languages
mum	Maiwala
muo	Nyong
muo-x-memeka	Memeka
mup	Malvi
muq	东部次方言
mur	Murle
mus	Creek
mut	Western Muria
mut-Deva-muriyawest	Muriya - Western
muu	Yaaku
muv	Muthuvan
mux	Bo-Ung
mux-x-timboka	Timboka
muy	Muyang
muz	Mursi
mva	Manam
mva-x-wanir	Wanir
mvb	Mattole
mvd	Mamboru
mve	مارواري (Pakistan)
mvf	周边蒙古语
mvg	Yucuañe Mixtec
mvh	Mulgi
mvi	宮古口
mvk	Mekmek
mvm	木雅语
mvn	Minaveha
mvo	Marovo
mvp	Duri
mvq	Moere
mvr	Marau
mvs	Massep
mvt	Mpotovoro
mvu	Marfa
mvv	Tagal Murut
mvv-x-punanlepaga	Punan Lepaga
mvw	Machinga
mvx	Meoswar
mvy	کوہستانی زبان
mvz	Mesqan
mwa	Mwatebu
mwb	Juwal
mwc	Are
mwe	Chimwera
mwf	Murrinh-Patha
mwg	Aiklep
mwh	Mouk-Aria
mwi	Labo
mwk	Kita Maninkakan
mwl	Mirandese
mwm	Sar
mwm-x-nar	Nar
mwn	Nyamwanga
mwn-MW-namwanga	Namwanga
mwo	Central Maewo
mwp	Kala Lagaw Ya
mwq	Mün Chin
mwq-x-chora	Cho Rah
mwq-x-nise	Ni-Se
mwr	Marwari
mws	Mwimbi-Muthambi
mwt	Moken
mwv	Mentawai
mww	白苗方言
mww-VN-hmongtrang	Hmong Trang
mwx	Mediak
mwz	Moingi
mxa	Northwest Oaxaca Mixtec
mxb	Tezoatlán Mixtec
mxc	Manyika
mxc-MZ-chimanika	Chimanika
mxd	Modang
mxe	Mele-Fila
mxf	Malgbe
mxg	Mbangala
mxh	Mvuba
mxi	Mozarabic
mxj	Miju-Mishmi
mxk	Monumbo
mxl	Maxi Gbe
mxm	Meramera
mxn	Moi (Indonesia)
mxn-x-moikelin	Moi Kelin
mxn-x-moiklasa	Moi Klasa
mxn-x-moisigin	Moi Sigin
mxn-x-salkma	Moi Salkma
mxo	Mbowe
mxp	Tlahuitoltepec Mixe
mxq	Juquila Mixe
mxr	Murik (Malaysia)
mxs	Huitepec Mixtec
mxt	Jamiltepec Mixtec
mxu	Mada (Cameroon)
mxv	Metlatónoc Mixtec
mxw	Namo
mxx	Mahou
mxy	Southeastern Nochixtlán Mixtec
mxz	Central Masela
my	ျမန္မာစာ
myb	Mbay
myc	Mayeka
myd	Maramba
mye	Myene
myf	Bambassi
myg	Manta
myh	Makah
myi	Mina (India)
myj	Mangayat
myk	Mamara Senoufo
myl	Moma
mym	Me'en
myo	Anfillo
myp	Pirahã
myr	Muniche
myu	Mundurukú
myv	Эрзя́нский
myw	Muyuw
myw-x-lougwau	Lougau
myx	Masaaba
myx-x-ludadiri	Ludadiri
myy	Macuna
myz	Classical Mandaic
mza	Santa María Zacatepec Mixtec
mzb	تونژابت
mzc	Madagascar Sign Language
mzd	Malimba
mze	Morawa
mzg	Monastic Sign Language
mzh	Wichí Lhamtés Güisnay
mzi	Ixcatlán Mazatec
mzj	Manya
mzk	Nigeria Mambila
mzl	Mazatlán Mixe
mzm	Mumuye
mzm-x-zing	Mumuye Zing
mzn	زبان مازندرانی
mzo	Matipuhy
mzp	Movima
mzq	Mori Atas
mzr	Marúbo
mzs	Macanese
mzt	Mintil
mzu	Inapang
mzv	Manza
mzw	Deg
mzx	Mawayana
mzy	Mozambican Sign Language
mzz	Maiadomu
na	Ekakairũ Naoero
naa	Namla
nab	Southern Nambikuára
nac	Narak
nad	Nijadali
naf	Nabak
naf-x-lowernabak	Nabak Lower
nag	Naga Pidgin
naj	Nalu
nak	Nakanai
nak-x-auka	Auka
nak-x-babata	Babata
nak-x-bagela	Bagela
nak-x-balo	Balo
nak-x-bibisi	Bibisi
nak-x-bileki	Bileki
nak-x-gaekeke	Gaekeke
nak-x-kae	Kae
nak-x-kotou	Kotou
nak-x-lavege	Lavege
nak-x-loa	Loa
nak-x-loso	Loso
nak-x-maututu	Maututu
nak-x-mouvai	Mouvai
nak-x-sisimi	Sisimi
nak-x-tarobi	Tarobi
nak-x-vere	Vere
nal	Nalik
nam	Ngan'gityemerri
nan	闽南语
nan-x-hokien	Hokkien
nan-x-teochi	Teochiu
nao	Naaba
nap	Neapolitan
naq	Khoekhoe
nar	Iguta
nas	Naasioi
nat	Ca̱hungwa̱rya̱
naw	Nawuri
nax	Nakwi
nay	Narrinyeri
naz	Coatepec Nahuatl
nb	Norsk bokmål
nba	Nyemba
nba-x-thiwiko	Thiwiko
nbb	Ndoe
nbc	Chang Naga
nbd	Ngbinda
nbe	Konyak Naga
nbh	Ngamo
nbi	Mao Naga
nbj	Ngarinman
nbk	Nake
nbm	Ngbaka Ma'bo
nbn	Kuri
nbo	Nkukoli
nbp	Nnam
nbq	Nggem
nbr	Numana-Nunku-Gbantu-Numbu
nbs	Namibian Sign Language
nbt	Na
nbt-x-nah	Nah
nbu	Rongmei Naga
nbv	Ngamambo
nbw	Southern Ngbandi
nby	Ningera
nca	Iyo
nca-x-koiyaka	Koiyaka
nca-x-nekene	Nekene
ncb	Central Nicobarese
ncc	Ponam
ncd	Nachering
nce	Yale
ncf	Notsi
ncg	Nisga'a
nch	Central Huasteca Nahuatl
nci	Classical Nahuatl
ncj	Northern Puebla Nahuatl
nck	Nakara
ncl	Michoacán Nahuatl
ncm	Nambo
ncn	Nauna
nco	Sibe
ncp	Ndaktup
ncr	Ncane
ncs	Nicaraguan Sign Language
nct	Chothe Naga
ncu	Chumburung
ncx	Central Puebla Nahuatl
ncz	Natchez
nd	isiNdebele
nda	Ndasa
ndb	Kenswei Nsei
ndc	Ndau
ndd	Nde-Nsele-Nta
ndf	Nadruvian
ndg	Ndengereko
ndh	Ndali
ndh-x-chindali	Chindali (Malawi)
ndh-x-chisukwa	Chisukwa
ndi	Samba Leko
ndj	Ndamba
ndk	Ndaka
ndl	Ndolo
ndm	Ndam
ndn	Ngundi
ndp	Ndo
ndq	Ndombe
ndr	Ndoola
nds	Low German
ndt	Ndunga
ndu	Dugun
ndv	Ndut
ndw	Ndobo
ndx	Nduga
ndy	Lutos
ndz	Ndogo
ne	नेपाली
nea	Eastern Ngad'a
neb	Toura (Côte d'Ivoire)
nec	Nedebang
ned	Nde-Gbite
nee	Nêlêmwa-Nixumwak
nef	Nefamese
neg	Негидальский
neh	Nyenkha
nei	Neo-Hittite
nej	Neko
nek	Neku
nem	Nemi
nen	Nengone
neo	Ná-Meo
nep-x-pahari	Pahari
neq	North Central Mixe
ner	Yahadian
nes	Bhoti Kinnauri
net	Nete
neu	Neo
nev	Nyaheun
new	नेवाः भाय्
nex	Neme
ney	Neyo
nez	Nez Perce
nfa	Dhao
nfd	Ahwai
nfl	Ayiwo
nfr	Nafaanra
nfu	Mfumte
ng	Owambo
nga	Ngbaka
ngb	Northern Ngbandi
ngc	Ngombe (Democratic Republic of Congo)
ngc-x-bodjenga	Bodjenga
ngc-x-bondjale	Bondjale
ngc-x-muwera	Muwera
ngd	Ngando (Central African Republic)
nge	Ngemba
ngg	Ngbaka Manza
ngh	N|u
ngi	Ngəzəm
ngj	Ngie
ngk	Dalabon
ngl	Lomwe
ngm	Ngatik Men's Creole
ngn	Ngwo
ngo	Ngoni
ngp	Ngulu
ngq	Ngurimi
ngr	Engdewu
ngs	Gvoko
ngt	Kriang
ngu	Guerrero Nahuatl
ngw	Ngwaba
ngx	Nggwahyi
ngy	Tibea
ngz	Ngungwel
nha	Nhanda
nhb	Beng
nhb-x-anoh	Anoh
nhc	Tabasco Nahuatl
nhd	Chiripá
nhe	Eastern Huasteca Nahuatl
nhf	Nhuwala
nhg	Tetelcingo Nahuatl
nhh	Nahari
nhi	Zacatlán-Ahuacatlán-Tepetzintla Nahuatl
nhk	Isthmus-Cosoleacaque Nahuatl
nhm	Morelos Nahuatl
nhn	Central Nahuatl
nho	Takuu
nhp	Isthmus-Pajapan Nahuatl
nhq	Huaxcaleca Nahuatl
nhr	Naro
nht	Ometepec Nahuatl
nhu	Noone
nhv	Temascaltepec Nahuatl
nhw	Western Huasteca Nahuatl
nhx	Isthmus-Mecayapan Nahuatl
nhy	Northern Oaxaca Nahuatl
nhz	Santa María La Alta Nahuatl
nia	Nias
nia-x-telo	Telo
nia-x-telukdalam	Teluk Dalam
nib	Nakame
nid	Ngandi
nie	Niellim
nif	Nek
nih	Nyiha (Tanzania)
nii	Nii
nij	Ngaju
nij-x-baream	Dayak Baream
nij-x-dayakbulik	Dayak Bulik
nij-x-dayakmali	Dayak Mali
nij-x-dayaktengon	Dayak Tengon
nij-x-kahayan	Dayak Kahayan
nij-x-kapuas	Dayak Kapuas
nij-x-katingan	Dayak Katingan
nij-x-katinganhilir	Katingan Hilir
nij-x-katinganhulu	Katingan Hulu
nij-x-katingantengah	Katingan Tengah
nij-x-manyan	Manyan
nij-x-menuhing	Menuhing Tehang
nij-x-nyadupm	Dayak Nyadupm
nij-x-runganmanu	Rungan Manuhing
nij-x-sambadanum	Samba Danum
nij-x-sampit	Sampit
nik	Southern Nicobarese
nim	Nilamba
nin	Ninzo
nio	Нганасанский
niq	Nandi
nir	Nimboran
nis	Nimi
nit	Southeastern Kolami
niu	Niuean
niv	Нивхский
niw	Nimo
nix	Hema
niy	Ngiti
niz	Ningil
nja	Nzanyi
njb	Nocte Naga
njd	Ndonde Hamba
njh	Lotha Naga
nji	Gudanji
njj	Njen
njl	Njalgulgule
njm	Angami Naga
njn	Liangmai Naga
njo	Ao Naga
njr	Njerep
njs	Nisa
njt	Ndyuka-Trio Pidgin
njx	Kunyi
njy	Njyem
njz	Nyishi
njz-x-hillmiri	Hill Miri
nka	Nkoya
nkb	Khoibu Naga
nkc	Nkongho
nkd	Koireng
nke	Duke
nkf	Inpui Naga
nkg	Nekgini
nkg-x-damoing	Damoing
nkg-x-goriong	Goriong
nkg-x-warai	Warai
nkh	Khezha Naga
nki	Thangal Naga
nkj	Nakai
nkk	Nokuku
nkm	Namat
nkn	Nkangala
nko	Nkonya
nkp	Niuatoputapu
nkq	Nkami
nkr	Nukuoro
nks	North Asmat
nkt	Nyika
nku	Bouna Kulango
nkv	Nyika (Malawi and Zambia)
nkw	Nkutu
nkx	Nkoroo
nkz	Nkari
nl	Nederlands, Vlaams
nla	Ngombale
nlc	Nalca
nle	East Nyala
nle-KE-lunyala	Lunyala
nlg	Gela
nli	ننگلامی
nlj	Nyali
nlk	Ninia Yali
nll	Nihali
nlo	Ngul
nlo-x-bangholu	Bangholu
nlo-x-ngwi	Ngwi
nlq	Lao Naga
nlu	Nchumbulu
nlv	Orizaba Nahuatl
nlx	Nahali
nly	Nyamal
nlz	Nalögo
nma	Maram Naga
nmb	Big Nambas
nmb-x-ndzra	Ndzra
nmc	Ngam
nmd	Ndumu
nme	Mzieme Naga
nmf	Tangkhul Naga (India)
nmf-x-phalang	Phalang
nmg	Kwasio
nmg-x-mabi	Mabi
nmh	Monsang Naga
nmi	Nyam
nmj	Ngombe (Central African Republic)
nmk	Namakura
nml	Ndemli
nmm	ङ्‍येश्याङ्‍ते
nmn	!Xóõ
nmo	Moyon Naga
nmo-x-tangshang	Tang Shang Naga
nmq	Nambya
nmr	Nimbari
nms	Letemboi
nmt	Namonuito
nmu	Northeast Maidu
nmw	Nimoa
nmx	Nama (Papua New Guinea)
nmy	納木依語
nmz	Nawdm
nn	Norsk nynorsk
nna	Nyangumarta
nnb	Nande
nnb-x-kinyabwito	Kinyabwito
nnb-x-kishula	Kishula
nnc	Nancere
nnd	West Ambae
nnd-x-nduindui	Nduindui
nne	Ngandyera
nnf	Ngaing
nnf-x-maibang	Maibang
nnf-x-sor	Sor
nng	Maring Naga
nnh	Ngiemboon
nni	North Nuaulu
nnj	Nyangatom
nnk	Nankina
nnl	Northern Rengma Naga
nnm	Namia
nnn	Ngete
nnp	Wancho Naga
nnq	Ngindo
nnr	Narungga
nns	Ningye
nnt	Nanticoke
nnu	Dwang
nnw	Southern Nuni
nnz	Nda'nda'
no	Norsk
noa	Woun Meu
noc	Nuk
nod	Northern Thai
noe	Nimadi
nof	Nomane
nog	Ногайский
noh	Nomu
noi	Noiri
noj	Nonuya
nok	Nooksack
nol	Nomlaki
nom	Nocamán
non	Norrœnt mál
nop	Numanggang
noq	Ngongo
nos	东尼苏语
not	Nomatsiguenga
nou	Ewage-Notu
nou-x-beuga	Beuga
nou-x-okena	Okena
nou-x-puea	Puea
nou-x-sowerapa	Sowerapa
nou-x-yega	Yega
nou-x-yewabuie	Yewa Buie
nov	Novial
now	Nyambo
noy	Noy
noz	Nayi
npa	Nar Phu
npb	Nupbikha
npg	Ponyo-Gongwang Naga
nph	Phom Naga
npi	नेपाली (individual language)
npl	Southeastern Puebla Nahuatl
npn	Mondropolon
npo	Pochuri Naga
nps	Nipsan
npu	Puimei Naga
npy	Napu
nqg	Southern Nago
nqk	Kura Ede Nago
nqm	Ndom
nqn	Nen
nqo	N'Ko
nqq	Kyan-Karyaw Naga
nqt	Nteng
nqy	Akyaung Ari Naga
nr	isiNdebele
nra	Ngom
nrb	Nara
nrc	Norisch
nre	Southern Rengma Naga
nrf	Jèrriais
nrg	Narango
nri	Chokri Naga
nrk	Ngarla
nrl	Ngarluma
nrm	Narom
nrn	Norn
nrp	North Picene
nrt	Northern Kalapuya
nru	东部方言
nrz	Lala
nsa	Sangtam Naga
nsc	Nshi
nsd	南尼苏语
nse	Nsenga
nse-MZ-nsenga	Nsenga
nse-x-ngoni	Ngoni
nsf	Northwestern Nisu
nsg	Ngasa
nsh	Ngoshie
nsi	Nigerian Sign Language
nsk	Naskapi
nsl	Norwegian Sign Language
nsm	Sumi Naga
nsn	Nehan
nso	Pedi
nsp	नेपाली सांकेतिक भाषा
nsq	Northern Sierra Miwok
nsr	Maritime Sign Language
nss	Nali
nst	Tase Naga
nst-x-longchang	Longchang
nst-x-muklom	Muklom
nst-x-nanel	Nanel
nst-x-ransenaga	Ran Se Naga
nst-x-sangwan	Sangwan
nst-x-sheju	Shechu
nst-x-shekyu	Shekyu
nsu	Sierra Negra Nahuatl
nsv	西南尼苏语
nsw	Navut
nsx	Songo
nsy	Nasal
nsz	Nisenan
ntd	Northern Tidung
nte	Nathembo
nti	Natioro
ntj	Ngaanyatjarra
ntk	Ikoma-Nata-Isenye
ntm	Nateni
nto	Ntomba
ntp	Northern Tepehuan
ntr	Delo
ntu	Natügu
ntw	Nottoway
ntx	Tangkhul Naga (Myanmar)
nty	Mantsi
ntz	زبان نطنزی
nua	Yuanga
nuc	Nukuini
nud	Ngala
nue	Ngundu
nuf	怒苏语
nuf-x-shawa	Shawa
nuf-x-wawa	Wawa
nuh	Ndunda
nui	Ngumbi
nuj	Nyole
nuk	Nuu-chah-nulth
nul	Nusa Laut
num	Niuafo'ou
nun	阿侬语
nuo	Tiếng Nguồn
nup	Nupe-Nupe-Tako
nuq	Nukumanu
nur	Nukuria
nus	Nuer
nut-x-north	Northern Nung
nut-x-south	Tiếng Nùng (Viet Nam)
nut-x-taynhan	Tày Nhắn
nut-x-xuong	Xuòng Giay
nuu	Ngbundu
nuv	Northern Nuni
nuv-x-extrnornuni	Extreme Northern Nuni
nuw	Nguluwan
nux	Mehek
nuy	Nunggubuyu
nuz	Tlamacazapa Nahuatl
nv	Diné bizaad
nvh	Nasarian
nvm	Namiae
nvo	Nyokon
nwa	Nawathinehena
nwb	Nyabwa
nwc	पुलां भाय्
nwe	Ngwe
nwi	Southwest Tanna
nwm	Nyamusa-Molo
nwr	Nawaru
nww	Ndwewe
nwx	Middle Newar
nwy	Nottoway-Meherrin
nxa	Nauete
nxd	Ngando (Democratic Republic of Congo)
nxe	Nage
nxg	Ngad'a
nxi	Nindi
nxk	Koki Naga
nxl	South Nuaulu
nxm	Numidian
nxo	Ndambomo
nxq	西部方言
nxq-x-malimasa	Malimasa
nxr	Ninggerum
nxu	Narau
nxx	Nafri
ny	chiCheŵa, chinyanja
nya-x-kunda	Kunda
nya-x-makwemarav	Makwe Marave
nya-x-nyanja	Nyanja
nyb	Nyangbo
nyc	Nyanga-li
nyd	Nyore
nye	Nyengo
nyf	Giryama
nyf-x-kambe	Kambe
nyf-x-rabai	Rabai
nyf-x-ribe	Ribe
nyg	Nyindu
nyh	Nyigina
nyi	Ama (Sudan)
nyj	Nyanga
nyj-x-kikobo	Kikobo
nyj-x-kitiri	Kitiri
nyk	Nyaneka
nyk-x-nyanehumbe	Nyaneka Humbe
nyl	Nyeu
nym	Nyamwezi
nym-x-nyanyembe	Nyanyembe
nym-x-nyikungu	Nyikungu
nyn	Nyankole
nyn-x-runyaruguru	Runyaruguru
nyn-x-rutagwenda	Rutagwenda
nyo	Nyoro
nyp	Nyang'i
nyq	زبان نائینی
nyr	Nyiha (Malawi)
nys	Nyunga
nyu	Nyungwe
nyu-x-nhungue	Nhungue
nyu-x-nselelo	Nselelo
nyu-x-tonga	Tonga
nyw	Nyaw
nyy	Nyakyusa-Ngonde
nza	Tigon Mbembe
nza-x-mbembnthal	Mbembe Nthale
nzb	Njebi
nzi	Nzima
nzk	Nzakara
nzm	Zeme Naga
nzs	New Zealand Sign Language
nzu	Teke-Nzikou
nzy	Nzakambay
nzz	Nanga Dama Dogon
oaa	Орокский
oac	Орочский
oar	Old Aramaic (up to 700 BCE)
oav	Old Avar
obi	Obispeño
obk	Southern Bontok
obl	Oblo
obm	Moabite
obo	Obo Manobo
obr	Old Burmese
obt	Old Breton
obu	Obulom
oc	occitan, lenga d'òc
oca	Ocaina
och	Old Chinese
oco	Old Cornish
ocu	Atzingo Matlatzinca
oda	Odut
odk	Od
odt	Old Dutch
odu	Odual
ofo	Ofo
ofs	Old Frisian
ofu	Efutop
ogb	Ogbia
ogc	Ogbah
oge	ႤႬႠჂ ႵႠႰႧႳႪႨ
ogg	Ogbogolo
ogo	Khana
ogu	Ogbronuagum
oht	Old Hittite
ohu	Old Hungarian
oia	Oirata
oin	Inebu One
oj	ᐊᓂᔑᓈᐯᒧᐎᓐ
ojb	Northwestern Ojibwa
ojc	Central Ojibwa
ojg	Eastern Ojibwa
ojp	上代日本語
ojs	Severn Ojibwa
ojv	Ontong Java
ojw	Western Ojibwa
oka	Okanagan
okb	Okobo
okd	Okodia
oke	Okpe (Southwestern Edo)
okh	Koresh-e Rostam
oki	Okiek
okk	Kwamtim One
okl	Old Kentish Sign Language
okm	중세국어
okn	島ムニ
oko	Old Korean (3rd-9th cent.)
okr	Kirike
oks	Oko-Eni-Osayen
oku	Oku
okv	Orokaiva
okv-x-bokoro	Bokoro
okv-x-harawa	Harawa
okv-x-kainake	Kaina Ke
okv-x-orokaifane	Orokaiva Ihane
okv-x-pahina	Pahina
okx	Okpe (Northwestern Edo)
ola	Walungge
old	Mochi
ole	Olekha
olk	Olkol
olm	Oloma
olo	Ливвиковское наречие
olr	Olrat
olt	Old Lithuanian
olu	Mucubal
om	Afaan Oromoo
oma	Omaha-Ponca
omb	East Ambae
omc	Mochica
omg	Omagua
omi	Omi
omk	Омокский язык
oml	Ombo
omn	Minoan
omo	Utarmbung
omp	Old Manipuri
omr	Old Marathi
omt	Omotik
omw	South Tairora
omw-x-bonta	Bonta
omw-x-dosara	Dosara
omw-x-kusingakua	Kusinga Kua
omw-x-marawak	Marawak
omw-x-obura	Obura
omw-x-piora	Piora
omw-x-tookena	Tookena
omw-x-waisaram	Waisaram
omx	Old Mon
onb	臨高語
one	Oneida
ong	Olo
oni	Onin
onj	Onjob
onk	Kabore One
onn	Onobasulu
ono	Onondaga
onp	Sartang
onr	Northern One
ons	Ono
ont	Ontenu
onu	Unua
onw	Old Nubian
onx	Onin Based Pidgin
ood	Tohono O'odham
oog	Ong
oon	Önge
oor	Oorlams
oos	Old Ossetic
opa	Okpamheri
opk	Kopkaka
opm	Oksapmin
opo	Opao
opy	Ofayé
or	ଓଡ଼ିଆ
ora	Oroha
orc	Orma
ore	Orejón
org	Oring
orh	鄂伦春语
orn	Orang Kanaq
oro	Orokolo
orr	Oruma
ors	Orang Seletar
ors-x-oranglau	Suku Laut; Orang Laut
ort	Adivasi Oriya
oru	اورمڑی
orv	Древнерусский язык
orw	Oro Win
orx	Oro
ory	Oriya (individual language)
ory-x-amanatya	Amanatya
orz	Ormu
orz-x-rarankwa	Raran'kwa
os	ирон æвзаг
osa	Osage
osc	Oscan
osi	Osing
oso	Ososo
osp	Romance Castellano
ost	Osatu
osu	Southern One
osx	Sahsisk
ota	Osmanlı Türkçesi
otb	Old Tibetan
otd	Ot Danum
otd-x-belaban	Dayak Belaban
otd-x-dayakdohoi	Dayak Uud Danum
otd-x-dayaklimbai	Dayak Limbai
otd-x-dohoy	Dohoy
otd-x-kadori	Kadorih
otd-x-kadorih	Dayak Kadorih
otd-x-mahalat	Mahalat
otd-x-oruundaan	Dayak Oruung Da'an
otd-x-pangindaan	Dayak Pangin Daan
otd-x-punankuhi	Punan Kuhi
otd-x-rangsa	Rangsa
otd-x-uudanumwkali	Uud Danum Ambalau Serawai
ote	Mezquital Otomi
otk	Old Turkic
otl	Tilapa Otomi
otm	Eastern Highland Otomi
otn	Tenango Otomi
otq	Querétaro Otomi
otr	Otoro
ots	Estado de México Otomi
ott	Temoaya Otomi
otw	Ottawa
otx	Texcatepec Otomi
oty	Old Tamil
otz	Ixtenco Otomi
oua	اللهجة الأمازيغية الورقلية
oub	Glio-Oubi
oue	Oune
oui	回鹘语
owi	Owiniga
owl	Old Welsh
oyb	Oy
oyd	Oyda
oym	Wayampi
oyy	Oya'oya
ozm	Koonzime
ozm-x-nzime	Nzime
pa	ਪੰਜਾਬੀ, پنجابی‎
pab	Parecís
pac	Pacoh
pad	Paumarí
pae	Pagibete
paf	Paranawát
pag	Pangasinan
pah	Tenharim
pai	Pe
pak	Parakanã
pal	Pahlavi
pam	Pampanga
pao	Northern Paiute
pap	Papiamento
paq	Parya
paq-x-leghmani	Parya Leghmani
par	Panamint
pas	Papasena
pat	Papitalai
pau	Palauan
pav	Pakaásnovos
paw	Pawnee
pax	Pankararé
pay	Pech
paz	Pankararú
pbb	Páez
pbc	Patamona
pbe	Mezontla Popoloca
pbf	Coyotepec Popoloca
pbg	Paraujano
pbh	E'ñapa Woromaipu
pbi	Parkwa
pbl	Mak (Nigeria)
pbm	Puebla and Northeastern Mazatec
pbn	Kpasam
pbo	Papel
pbp	Badyara
pbr	Pangwa
pbs	Central Pame
pbt	پښتو
pbu	یوسفزئی پښتو
pbv	Pnar
pby	Pyu (Papua New Guinea)
pca	Santa Inés Ahuatempan Popoloca
pcb	Pear
pcc	布依语
pcc-x-giaynhan	Giay Nhan
pcd	Picard
pce	Ruching Palaung
pcf	Paliyan
pcg	Paniya
pch	Pardhan
pci	Duruwa
pcj	Parenga
pck	Paite Chin
pcl	Pardhi
pcl-Deva-pardhi	Pardhi
pcl-x-thakan	Thakan
pcm	Nigerian Pidgin
pcn	Piti
pcn-x-ribang	Ribang
pcp	Pacahuara
pcw	Pyapun
pda	Anam
pdc	Pennsylvania German
pdi	Pa Di
pdn	Podena
pdo	Padoe
pdt	Plautdietsch
pdu	Kayan
pea	Peranakan Indonesian
peb	Eastern Pomo
ped	Mala (Papua New Guinea)
ped-x-aidibal	Aidibal
ped-x-akefa	Akefa
ped-x-beteka	Beteka
ped-x-busip	Busip
ped-x-dagui	Dagui
ped-x-malala	Malala
ped-x-sapra	Sapra
ped-x-tarikapa	Tarikapa
pee	Taje
pef	Northeastern Pomo
peg	Pengo
peh	保安语
pei	Chichimeca-Jonaz
pej	Northern Pomo
pek	Penchal
pel	Pekal
pem	Phende
pem-x-gipendega	Gipende Gatundu
pem-x-gipendegu	Gipende Gungu
pem-x-pindi	Kipindi
peo	Old Persian (ca. 600-400 B.C.)
pep	Kunja
peq	Southern Pomo
pes	فارسی
pes-x-bandari	Bandari
pex	Petats
pex-x-matsungan	Maysungan
pey	Petjo
pez	Eastern Penan
pez-x-longiman	Long Iman
pfa	Pááfang
pfe	Peere
pfl	Pfaelzisch
pga	Sudanese Creole Arabic
pgd	Gāndhārī
pgg	Pangwali
pgi	Pagi
pgk	Rerep
pgl	Gaeilge Ársa
pgn	Paelignian
pgs	Pangseng
pgu	Pagu
pha	Pa-Hng
pha-x-pathan	Pa Than
phd	Phudagi
phg	Phuong
phh	Phukha
phk	Phake
phl	پھالولہ زبان
phm	Phimbi
phn	Phoenician
pho	Phunoi
pho-x-taihe	Tai He
phq	Phana'
phr	پوٹھواری
pht	Phu Thai
phu	Phuan
phv	Pahlavani
phw	Phangduwali
pi	पाऴि
pia	Pima Bajo
pib	Yine
pic	Pinji
pid	Piaroa
pie	Piro
pif	Pingelapese
pig	Pisabo
pih	Pitcairn-Norfolk
pii	Pini
pil	Yom
pim	Powhatan
pin	Piame
pio	Piapoco
pip	Pipero
pir	Piratapuyo
pis	Pijin
piu	Pintupi-Luritja
piv	Pileni
piw	Pimbwe
pix	Piu
piy	Piya-Kwonci
piy-x-wurkum	Wurkum
piz	Pije
pjt	Pitjantjatjara
pka	Ardhamāgadhī Prākrit
pkb	Pokomo
pkc	백제어
pkg	Pak-Tong
pkh	Pankhu
pkn	Pakanha
pko	Pökoot
pkp	Pukapuka
pkr	Attapady Kurumba
pks	Pakistan Sign Language
pkt	Maleng
pku	Paku
pl	język polski, polszczyzna
pla	Miani
pla-x-dugumur	Dugumur
pla-x-mianinorth	Miani North
pla-x-raraiba	Raraiba
pla-x-rarin	Rarin
pla-x-sibera	Sibera
pla-x-simbine	Simbine
pla-x-widaro	Widaro
plb	Polonombauk
plc	Central Palawano
plc-x-taotbato	Palawan Taot Bato
pld	Polari
ple	Palu'e
plg	Pilagá
plh	Paulohi
plj	Polci
plk	شینا زبان
pll	Shwe Palaung
pln	Palenquero
plo	Oluta Popoluca
plq	Palaic
plr	Palaka Senoufo
pls	San Marcos Tlacoyalco Popoloca
plt	Plateau Malagasy
plt-x-antaifasy	Antaifasy
plt-x-antambahoaka	Antambahoaka
plt-x-ikongotanala	Ikongo Tanala
plt-x-sbetsileo	Southern Betsileo
plt-x-sihanaka	Sihanaka
plt-x-tanala	Tanala
plt-x-zafimaniry	Zafimaniry
plu	Palikúr
plv	Southwest Palawano
plv-x-taotba	Tao't Bato
plw	Brooke's Point Palawano
ply	巴琉语
plz	Paluan
pma	Paama
pmb	Pambia
pme	Pwaamei
pmf	Pamona
pmf-x-wana	Wana
pmh	महाराष्ट्री प्राकृत
pmi	普米语
pmj	南普米语
pmk	Pamlico
pmm	Pomo
pmn	Pam
pmo	Pom
pmo-x-miosindi	Miosindi
pmo-x-serewen	Serewen
pmq	Northern Pame
pmr	Paynamar
pms	Piemontese
pmt	Tuamotuan
pmw	Plains Miwok
pmx	Poumei Naga
pmy	Papuan Malay
pna	Punan Bah-Biau
pna-x-punanhalanga	Punan Halanga
pnb	پنجابی‎
pnb-x-faqirparsi	Faqir Parsi
pnc	Pannei
pne	Western Penan
png	Pongu
pnh	Penrhyn
pni	Aoheng
pnk	Paunaka
pnl	Paleni
pnm	Punan Batu 1
pnn	Pinai-Hagahai
pnp	Pancana
pnq	Pana (Burkina Faso)
pnr	Panim
pns	Ponosakan
pnt	Pontic
pnu	炯奈
pnv	Pinigura
pnw	Panytyima
pnx	Phong-Kniang
pny	Pinyin
pnz	Pana
poc	Poqomam
poe	San Juan Atzingo Popoloca
pof	Poke
pog	Potiguára
poh	Poqomchi'
poi	Highland Popoluca
pok	Pokangá
pom	Southeastern Pomo
pon	Pohnpeian
poo	Central Pomo
pop	Pwapwâ
poq	Texistepec Popoluca
pos	Sayula Popoluca
pot	Potawatomi
pov	Upper Guinea Crioulo
pow	San Felipe Otlaltepec Popoloca
pox	Język połabski
poy	Pogolo
ppa	Pao
ppe	Papi
ppi	Paipai
ppk	Uma
ppl	Pipil
ppm	Papuma
ppn	Papapana
ppo	Folopa
ppp	Pelende
ppq	Pei
pps	San Luís Temalacayuca Popoloca
ppt	Pare
pqa	Pa'a
pqm	Malecite-Passamaquoddy
prb	Lua'
prc	Parachi
prd	Parsi-Dari
pre	Principense
prf	Paranan
prg	Prussian
prh	Porohanon
pri	Paicî
prk	Parauk
prl	Peruvian Sign Language
prm	Kibiri
prm-x-foroba	Foroba
prm-x-porome	Porome
prn	Vâs’i-vari
pro	Occitan ancian
prp	Parsi
prq	Ashéninka Perené
prs	دری
prt	Phai
pru	Puragi
prw	Parawen
prw-x-ale	Ale
prx	Purik
prz	Providencia Sign Language
ps	پښتو
psa	Asue Awyu
psc	Persian Sign Language
psd	Plains Indian Sign Language
pse	Central Malay
pse-x-bengkulu	Bengkulu
pse-x-enim	Enim
pse-x-ogan	Ogan
pse-x-pasemah	Pasemah
pse-x-riauasli	Suku Asli
pse-x-serawai	Serawai
psg	Penang Sign Language
psh	Southwest Pashai
psi	Southeast Pashai
psl	Puerto Rican Sign Language
psm	Pauserna
psn	Panasuan
pso	Polish Sign Language
psp	Philippine Sign Language
psq	Pasi
psr	Portuguese Sign Language
psr-x-capverdesl	Cabo Verdean Sign Language
psr-x-guinbisssl	Lingua Gestual Guineense
psr-x-saotomprsl	Língua Gestual de São Tomé e Príncipe
pss	Kaulong
pst	منځنۍ پښتو
psu	Śaurasenī Prākṛt
psw	Port Sandwich
pt	português
pta	Pai Tavytera
pt-br	Português
pth	Pataxó Hã-Ha-Hãe
pti	Pintiini
ptn	Patani
pto	Zo'é
ptp	Patep
ptq	Pattapu
ptr	Piamatsina
ptt	Enrekang
ptu	Bambam
ptv	Port Vato
ptw	Pentlatch
pty	Pathiya
pua	Western Highland Purepecha
pub	Purum
puc	Punan Merap
puc-x-kayangurek	Kayan Ngurek
puc-x-kayanmerap	Kayan Merap
puc-x-nahakramu	Naha Kramu
puc-x-tanglaan	Tang La'an
pud	Punan Aput
pud-x-punanbirun	Punan Birun
pud-x-punanmetut	Punan Metut
puf	Punan Merah
puf-x-mirau	Mirau
pug	Phuie
pui	Puinave
puj	Punan Tubu
puj-x-bilabekayuk	Punan Bila Bekayuk
puj-x-bintuan	Bintuan
puj-x-linaubahau	Punan Linau Bahau
puj-x-linohsempayan	Dayak Linoh Sempayan
puj-x-longlihi	Long Lihi
puj-x-longpada	Punan Long Pada
puj-x-longranau	Long Ranau
puj-x-longtiti	Long Titi
puj-x-menaburbes	Menabur Besar
puj-x-punanbengalan	Punan Bengalan
puj-x-punanmentarang	Punan Mentarang
puj-x-punansemeriot	Punan Semeriot
puj-x-riantubu	Rian Tubu
puj-x-sebaing	Sebaing
puk	Pu Ko
pum	पुमा
puo	Puoc
pup	Pulabu
puq	Puquina
pur	Puruborá
put	Putoh
put-x-dayakabai	Dayak Abai
puu	Punu
puw	Puluwatese
pux	Puare
puy	Purisimeño
pwa	Pawaia
pwb	Panawa
pwg	Gapapaiwa
pwi	Patwin
pwm	Molbog
pwn	Paiwan
pwo	Pwo Western Karen
pwr	Powari
pwr-x-marari	Marari
pww	Pwo Northern Karen
pxm	Quetzaltepec Mixe
pye	Pye Krumen
pym	Fyam
pyn	Poyanáwa
pys	Paraguayan Sign Language
pyu	Puyuma
pyx	Pyu (Myanmar)
pyy	Pyen
pzn	Para Naga
qaa-x-0123f0	Neko
qaa-x-0456d6	Kiruri/Ruri
qaa-x-0e4cba	Bram
qaa-x-112cc6	Dou
qaa-x-1e034f	Duduela
qaa-x-249d36	Ibalantoy
qaa-x-2a8b78	Miani
qaa-x-2cc8ae	Dayak Mentobi
qaa-x-39b560	Berefo
qaa-x-3e7fd4	Kou
qaa-x-4265f7	Kosena
qaa-x-429238	Natukar
qaa-x-4a6896	Khaltayee
qaa-x-4aff96	Phalang
qaa-x-51714f	Yoku
qaa-x-555217	Tasig
qaa-x-58a798	Yandang
qaa-x-5c370b	Boholano
qaa-x-60d198	Date
qaa-x-657797	Dayak Sisang
qaa-x-6d23fd	Kwato
qaa-x-6d5fd9	Nigum
qaa-x-6e8874	Wamas
qaa-x-700207	Luwisi
qaa-x-73bcad	Huaku Yao
qaa-x-788936	Dayak Banjur Simpang
qaa-x-93d6bb	TestLanguage
qaa-x-94e36e	SUN Homesign Aurangabad
qaa-x-a1bb05	Lukonzo
qaa-x-a39a46	Western Juxtlahuaca Mixtec
qaa-x-a3a290	Aluk Xekong
qaa-x-ac3d56	Dayak Paus
qaa-x-b25a78	Kuni
qaa-x-b90bc8	Ancient Hebrew
qaa-x-bbd7fc	Sawi Ayamon
qaa-x-c3f2af	Haya
qaa-x-c67de8	Serawai
qaa-x-d4f123	Zhuang
qaa-x-d6b7f6	B’laan Fungol
qaa-x-d8361a	Yodolo
qaa-x-d9109d	Matya Samo
qaa-x-e4f23d	Logea
qaa-x-ea94c6	Nda Kaka
qaa-x-f0c991	Uraw Language
qaa-x-f3a46e	Nengom
qaa-x-fbf054	Kwamba
qaa-x-fc164d	Nyesam
qaa-x-fd0df2	Wokea
qu	Runa Simi, Kichwa
qua	Quapaw
qub	Huallaga Huánuco Quechua
quc	K'iche'
qud	Calderón Highland Quichua
quf	Lambayeque Quechua
qug	Chimborazo Highland Quichua
quh	South Bolivian Quechua
qui	Quileute
quk	Chachapoyas Quechua
qul	North Bolivian Quechua
qum	Sipacapense
qun	Quinault
qup	Southern Pastaza Quechua
quq	Quinqui
qur	Yanahuanca Pasco Quechua
qus	Santiago del Estero Quichua
quv	Sacapulteco
quw	Tena Lowland Quichua
qux	Yauyos Quechua
quy	Ayacucho Quechua
quz	Cusco Quechua
qva	Ambo-Pasco Quechua
qvc	Cajamarca Quechua
qve	Eastern Apurímac Quechua
qvh	Huamalíes-Dos de Mayo Huánuco Quechua
qvi	Imbabura Highland Quichua
qvj	Loja Highland Quichua
qvl	Cajatambo North Lima Quechua
qvm	Margos-Yarowilca-Lauricocha Quechua
qvn	North Junín Quechua
qvo	Napo Lowland Quechua
qvp	Pacaraos Quechua
qvs	San Martín Quechua
qvw	Huaylla Wanca Quechua
qvy	却域语
qvz	Northern Pastaza Quichua
qwa	Corongo Ancash Quechua
qwc	Classical Quechua
qwh	Huaylas Ancash Quechua
qwm	Kuman (Russia)
qws	Sihuas Ancash Quechua
qwt	Kwalhioqua-Tlatskanai
qxa	Chiquián Ancash Quechua
qxc	Chincha Quechua
qxh	Panao Huánuco Quechua
qxl	Salasaca Highland Quichua
qxn	Northern Conchucos Ancash Quechua
qxo	Southern Conchucos Ancash Quechua
qxp	Puno Quechua
qxq	زبان ترکی قشقایی
qxr	Cañar Highland Quichua
qxs	Southern Qiang
qxt	Santa Ana de Tusi Pasco Quechua
qxu	Arequipa-La Unión Quechua
qxw	Jauja Wanca Quechua
qya	Quenya
qyp	Quiripi
raa	Dungmali
rab	चाम्लिङ
rac	Rasawa
rad	Rade
raf	Western Meohang
rag	Logooli
rah	Rabha
rai	Ramoaaina
raj	राजस्थानी
rak	Tulu-Bohuai
ral	Ralte
ram	Canela
ran	Riantana
rao	Rao
rap	Rapanui
raq	Saam
rar	Rarotongan
ras	Tegali
rat	Razajerdi
rau	Raute
rav	Sampang
raw	Rawang
rax	Rang
ray	Rapa
raz	Rahambuu
rbb	Rumai Palaung
rbk	Northern Bontok
rbl	Miraya Bikol
rbp	Barababaraba
rcf	Réunion Creole French
rdb	Rudbari
rea	Rerau
reb	Rembong
ree	Rejang Kayan
ree-x-punanlisum	Punan Lisum
reg	Kara (Tanzania)
rei	Reli
rej	Rejang
rel	Rendille
ren	Rengao
res	Reshe
ret	Retta
rey	Reyesano
rga	Roria
rge	Romano-Greek
rgk	Rangkas
rgn	Romagnol
rgr	Resígaro
rgs	Southern Roglai
rgu	Ringgou
rhg	Rohingya
rhp	Yahang
ria	Riang (India)
rie	Rien
rif	ⵜⴰⵔⵉⴼⵉⵜ
ril	Riang (Myanmar)
rim	Nyaturu
rin	Nungu
rir	Ribun
rir-x-dayakmaliperuan	Dayak Mali Peruan
rir-x-dayakmudu	Dayak Mudu
rir-x-dayaksami	Dayak Sami
rit	Ritarungo
riu	Riung
rjg	Rajong
rji	Raji
rjs	Rajbanshi
rka	Kraol
rka-x-tmoan	T'moan
rkb	Rikbaktsa
rkh	Rakahanga-Manihiki
rki	Rakhine
rki-x-marmas	Marmas
rkm	Marka
rkt	Rangpuri
rm	rumantsch grischun
rma	Rama
rmb	Rembarunga
rmc	Carpathian Romani
rmc-UA-romungro	Romungro Romani
rme	Angloromani
rmf	Kalo Finnish Romani
rmg	Traveller Norwegian
rmh	Murkim
rmi	Lomavren
rmk	Romkun
rmk-x-belwang	Belwang
rml	Baltic Romani
rml-RU-ruskaroma	Russian Roma
rmm	Roma
rmn	Balkan Romani
rmn-x-koshnichary	Koshnichary
rmn-x-lyashy	Lyashy
rmn-x-nbalkanrom	Northern Balkan Romani
rmn-x-sbalkanrom	Southern Balkan Romani
rmn-x-yerliroman	Yerli Romani
rmo	Sinte Romani
rmp	Rempi
rmq	Caló
rmr-x-bha	Hungarian Ardilean Bayash
rmr-x-bhm	Hungarian Muntean Bayash
rmr-x-bsa	South Slavic Ardilean Bayash
rmr-x-bsl	Slavic Ludari Bayash
rms	Romanian Sign Language
rmt	زبان دومری
rmt-JO-domari	Domari
rmt-SY-domari	Syrian Domari
rmu	Tavringer Romani
rmv	Romanova
rmw	Welsh Romani
rmx	Rơ-măm
rmy	Vlax Romani
rmy-RU-vlahi	Vlahi
rmy-UA-lovari	Lovari
rmy-x-vc	Vlach Čergarski
rmy-x-vg	Vlach Gurbert
rmy-x-vwa	Vlach Western Arli
rmz	Marma
rn	Ikirundi
rnd	Ruund
rng	Ronga
rnl	Ranglong
rnn	Roon
rnp	Rongpo
rnw	Rungwa
ro	limba română
rob	Tae'
roc	Cacgia Roglai
rod	tòRógó
roe	Ronji
rof	Rombo
rog	Tiếng Ra Glai
rol	Romblomanon
rom	Romany
roo	Rotokas
rop	Kriol
ror	Rongga
rou	Runga
row	Dela-Oenale
row-x-oenale	Oenale Rilulon
rpn	Repanbitip
rpt	Rapting
rri	Ririo
rro	Waima
rrt	Arritinngithigh
rsb	Romano-Serbian
rsl	Русский жестовый язык
rsl-x-kazakhsl	Kazakh-Russian Sign Language
rtc	Rungtu Chin
rth	Ratahan
rth-x-pasan	Pasan
rtm	Rotuman
rts	Yurats
rtw	Rathawi
ru	Русский
rub	Gungu
ruc	Ruuli
rue	Rusyn
ruf	Luguru
rug	Roviana
ruh	Ruga
rui	Rufiji
ruk	Che
run-x-kitwa	Kitwa
ruo	Istro Romanian
rup	Macedo-Romanian
ruq	Megleno Romanian
rut	Рутульский
ruu	Lanas Lobu
ruy	Mala (Nigeria)
ruz	Ruma
rw	Ikinyarwanda
rwa	Rawo
rwk	Rwa
rwl	Ruwila
rwm	Amba (Uganda)
rwo	Rawa
rwo-x-karo	Karo
rwr	Marwari (India)
rw-x-kinyabwisha	Kinyabwisha
rxd	Ngardi
rxw	Karuwali
ryn	奄美大島南部方言
rys	八重山物言
ryu	沖縄口/ウチナーグチ
rzh	Razihi
sa	संस्कृतम्
saa	Saba
sab	Buglere
sac	Meskwaki
sad	Sandawe
sae	Sabanê
saf	Safaliba
sah	Якутский
saj	Sahu
sak	Sake
sam	Samaritan Aramaic
sao	Sause
saq	Samburu
sas	Sasak
sat	Santali
sat-x-kamar	Kamar
sau	Saleman
sav	Saafi-Saafi
saw	Sawi
saw-x-erary	Sawi Erary
saw-x-sawierary	Sawi Erary
sax	Sa
say	Zaar
saz	Saurashtra
sba	Ngambay
sbb	Simbo
sbc	Kele (Papua New Guinea)
sbd	Southern Samo
sbe	Saliba
sbf	Chabu
sbg	Seget
sbh	Sori-Harengan
sbi	Seti
sbj	Surbakhal
sbk	Safwa
sbl	Botolan Sambal
sbm	Sagala
sbn	سندھی زبان
sbo	Sabüm
sbp	Sangu
sbq	Sileibi
sbr	Sembakung Murut
sbr-x-dayaksane	Dayak Sane
sbr-x-mudu	Dayak Mudu
sbr-x-senganan	Dayak Senganan
sbs	Subiya
sbs-x-chiikuhane	Chiikuhane
sbt	Kimki
sbt-x-asbe	Asbe
sbu	Stod Bhoti
sbv	Sabine
sbw	Simba
sbx	Seberuang
sbx-x-desa	Desa Kayan
sby	Soli
sbz	Sara Kaba
sc	sardu
scb	Chut
sce	东乡语
scf	San Miguel Creole French
scg	Sanggau
scg-x-cupangsembilan	Cupang Sembilan Domong
scg-x-dayakdosatn	Dayak Dosatn
scg-x-dayakkatarak	Dayak Katarak
scg-x-dayakkoman	Dayak Koman
scg-x-dayakmentrap	Dayak Mentrap
scg-x-dayaktebang	Dayak Tebang
scg-x-koman	Koman
scg-x-lebanghilir	Dayak Lebang Hilir
scg-x-linoh	Linoh
scg-x-mayau	Dayak Mayau
scg-x-sekuiam	Sekujam
scg-x-semerawai	Dayak Semerawai
sch	Sakachep
sci	Sri Lankan Creole Malay
sck	Sadri
scl	شینا
scn	Sicilian
sco	Scots
scp	Helambu Sherpa
scq	Sa'och
scs	North Slavey
scu	Shumcho
scv	Sheni
scw	Sha
scx	Sicel
sd	सिन्धी, سنڌي، سندھی‎
sda	Toraja-Sa'dan
sdb	شەبەکی
sdc	Sassarese Sardinian
sde	Kuvori
sdf	سارلی
sdg	Savi
sdh	کوردی خوارگ
sdh-x-kalhori	گویش‌های جنوبی کردی
sdj	Suundi
sdk	Sos Kundi
sdl	لغة الإشارة السعودية
sdm	Semandang
sdm-x-beginci	Dayak Beginci
sdm-x-dayakbihak	Dayak Bihak
sdm-x-dayakgerai	Dayak Gerai
sdm-x-kualant	Dayak Kualant
sdm-x-pangkalsuka	Dayak Pangkalan Suka
sdm-x-sekucngkua	Dayak Sekucing Kualan
sdn	Gallurese Sardinian
sdo	Bukar-Sadung Bidayuh
sdo-x-dayaktatoong	Dayak Tatoong
sdo-x-mentukar	Dayak Ntuka
sdp	Sherdukpen
sdr	Oraon Sadri
sdr-x-pahan	Pahan
sds-x-matmatberb	Matmata Berber
sdu	Sarudu
sdx	Sibu Melanau
sdz	Sallands
se	Davvisámegiella
sea	Semai
seb	Shempire Senoufo
sec	Sechelt
sed	Tiếng Xơ Đăng
see	Seneca
sef	Cebaara Senoufo
seg	Segeju
seh	Sena
sei	Seri
sek	Sekani
sel	Селькупский
sen	Nanerigé Sénoufo
seo	Suarmin
sep	Sìcìté Sénoufo
seq	Senara Sénoufo
ser	Serrano
ses	Koyraboro Senni Songhai
set	Sentani
set-x-csentani	Central Sentani
set-x-esentani	East Sentani
set-x-wsentani	West Sentani
seu	Serui-Laut
sev	Nyarafolo Senoufo
sew	Sewa Bay
sew-x-bokera	Bokera
sew-x-darubia	Darubia
sew-x-maibari	Maibari
sew-x-miadeba	Miadeba
sew-x-sawataitai	Sawataitai
sey	Secoya
sez	Senthang Chin
sfb	Langue des signes de Belgique Francophone
sfe	Eastern Subanen
sfm	小花苗
sfs	South African Sign Language
sfs-x-eswatinisl	eSwatini Sign Language
sfs-x-lesothosl	Lesotho Sign Language
sfw	Sehwi
sg	yângâ tî sängö
sga	Old Irish (to 900)
sgb	Mag-antsi Ayta
sgc	Kipsigis
sgc-x-dayaktobak	Dayak Tobak
sgd	Surigaonon
sge	Segai
sge-x-punankelai	Punan Kelai
sgg	Swiss-German Sign Language
sgh	Shughni
sgh-x-rushani	Rushani
sgi	Suga
sgj	Surgujia
sgk	桑孔
sgn	SUN
sgn-PY-asuncion1	Home Sign Asuncion 1
sgn-PY-Sun-ciudaddests1	SUN Homesign Ciudad del Ests 1
sgn-US-symbunot	Symbolic Universal Notation
sgn-UY-montevideo1	Home Sign Montevideo 1
sgn-x-aurangabad 1	Homesign Aurangabad 1
sgp	Singpho
sgr	زبان سنگسری
sgs	Samogitian
sgt	Brokpake
sgu	Salas
sgw	Sebat Bet Gurage
sgw-x-muher	Muher
sgx	Sierra Leone Sign Language
sgy	Sanglechi
sgz	Sursurunga
sha	Shall-Zwall
shb	Ninam
shc	Sonde
shd	Kundal Shahi
she	Sheko
shg	Shua
shh	Shoshoni
shi	ⵜⴰⵙⵓⵙⵙⵉⵜ
shj	Caning
shk	Shilluk
shl	Shendu
shm	Shahrudi
shn	Shan
sho	Shanga
shp	Shipibo-Conibo
shq	Sala
shr	Shi
shr-x-hwindja	Hwindja
shr-x-kigweshe	Kigweshegweshe
shr-x-kilinjalinja	Kilinjalinja
shr-x-kizibaziba	Kizibaziba
shr-x-longelonge	Longe-Longe
shs	Shuswap
sht	Shasta
shu	Chadian Arabic
shu-Arabic	Chadian Arabic
shv	لغة شحرية
shw	Shwai
shx	山客話
shy	لهجة شاوية
shz	Syenara Senoufo
si	සිංහල
sia	Бабинский
sib	Sebop
sid	Sidamo
sie	Simaa
sie-x-imilangu	Imilangu
sie-x-kwangwa	Kwangwa
sie-x-makoma	Makoma
sie-x-mwenyi	Mwenyi
sie-x-nyengo	Nyengo
sif	Siamou
sig	Paasaal
sih	Zire
sii	Shom Peng
sij	Numbami
sik	Sikiana
sil	Tumulung Sisaala
sim	Mende (Papua New Guinea)
sip	Sikkimese
siq	Sonia
sir	Siri
sis	Siuslaw
siu	Sinagen
siv	Sumariup
siw	Siwai
six	Sumau
six-x-tindong	Tindong
siy	زووآن ئ سیوندی
siz	تاسيويت
sja	Epena
sjb	Sajau Basap
sjb-x-pelancau	Punan Pelan Cau
sjd	Кильдинский саамский
sje	Pite Sami
sjg	Assangori
sjk	Kemi Sami
sjl	Sajalong
sjm	Mapun
sjn	Sindarin
sjo	锡伯语
sjp	Surjapuri
sjr	Siar-Lak
sjs	أمازيغية صنهاجة
sjt	Йоканьгско-саамский
sju	Ume Sami
sjw	Shawnee
sk	slovenčina, slovenský jazyk
ska	Skagit
skb	Saek
skc	Ma Manda
skd	Southern Sierra Miwok
ske	Seke (Vanuatu)
skf	Sakirabiá
skg	Sakalava Malagasy
skg-x-ananalava	Sakalava Ananalava
skg-x-besalampy	Sakalava Besalampy
skg-x-vezo	Vezo
skh	Sikule
ski	Sika
skj	Seke (Nepal)
skk	Sok
skm	Kutong
skn	Kolibugan Subanon
sko	Seko Tengah
skp	Sekapan
skq	Sininkere
skr	سرائیکی
sks	Maia
sks-x-dumudum	Dumudum
sks-x-milalimuda	Milalimuda
sks-x-rurunat	Rurunat
sks-x-suaro	Suaro
sks-x-tobenam	Tobenam
sks-x-vidaro	Vidaro
sks-x-wagedau	Wagedau
sks-x-yakiba	Yakiba
skt	Sakata
sku	Sakao
sku-x-noegabour	Noegabour
sku-x-portolry	Port Olry
skv	Skou
skv-x-moso	Moso
skx	Seko Padang
sky	Sikaiana
skz	Sekar
sl	slovenski jezik, slovenščina
slc	Sáliba
sld	Sissala
sle	Sholaga
slf	Swiss-Italian Sign Language
slg	Selungai Murut
slh	Southern Puget Sound Salish
sli	Lower Silesian
slj	Salumá
sll	Salt-Yui
slm	Pangutaran Sama
sln	Salinan
slp	Lamaholot
slp-x-pamakayu	Pamakayu
slr	撒拉语
sls	Singapore Sign Language
slt	Sila
slu	Selaru
slw	Sialum
slx	Salampasu
sly	Selayar
slz	Ma'ya
sm	gagana fa'a Samoa
sma	Southern Sami
smb	Simbari
smc	Som
smd	Sama
smf	Auwe
smg	Simbali
smh	撒梅语
smj	Lule Sami
smk	Bolinao
smk-x-Bolanons	Bol-Anons
sml	Central Sama
smm	Musasa
smn	Inari Sami
smp	Samaritan
smq	Samo
smr	Simeulue
sms	Skolt Sami
smt	Simte
smu	Somray
smv	Samvedi
smw	Sumbawa
smx	Samba
smy	زبان سمنانی
smz	Simeku
sn	chiShona
sna-x-doma	Doma
sna-x-korekore	Korekore
sna-x-shangwe	Shangwe
sna-ZM-goba	Goba
snb	Sebuyau
snc	Sinaugoro
snc-x-boku	Boku
snc-x-kamali	Kamali
snc-x-kemorupu	Kemorupu
snc-x-taboro	Taboro
sne	Bau Bidayuh
sne-x-dayaktengoh	Dayak Tengoh
sne-x-jagoibabang	Dayak Bidayuh Jagoi
snf	Noon
sng	Sanga (Democratic Republic of Congo)
snh	Shinabo
snj	Riverain Sango
snk	Soninke
snl	Sangil
snm	Southern Ma'di
snn	Siona
sno	Snohomish
snp	Siane
snp-x-wandodavar	Wandodavarasa
snq	Sangu (Gabon)
snr	Sihan
sns	South West Bay
snu	Senggi
snv	Sa'ban
snv-x-longbila	Dayak Long Bila
snw	Selee
snx	Sam
sny	Saniyo-Hiyewe
snz	Sinsauru
so	Soomaaliga, af Soomaali
soa	Thai Song
sob	Sobei
soc	So (Democratic Republic of Congo)
sod	Songoora
soe	Songomeno
sog	Sogdian
soh	Aka
soi	Sonha
soj	زبان سوی
sok	Sokoro
sol	Solos
som-x-kigoshi	Kigoshi
soo	Songo
sop	Songe
sop-x-kiyashi	Kiyashi
soq	Kanasi
sor	Somrai
sos	Seenku
sos-x-sambla	Sambla
sou	Southern Thai
sov	Sonsorol
sow	Sowanda
sox	Swo
soy	Miyobe
soz	Temi
spb	Sepa (Indonesia)
spc	Sapé
spd	Saep
spe	Sepa (Papua New Guinea)
spg	Sian
spg-x-punanrian	Punan Rian
spk	Sengo
spl	Selepet
spm	Akukem
spn	Sanapaná
spo	Spokane
spp	Supyire Senoufo
spq	Loreto-Ucayali Spanish
spr	Saparua
sps	Saposa
sps-x-bubuka	Boubouka
spt	Spiti Bhoti
spu	Sapuan
spv	Sambalpuri
spx	South Picene
spy	Sabaot
sqa	Shama-Sambuga
sqh	Shau
sqi	Shqip
sqk	Albanian Sign Language
sqm	Suma
sqn	Susquehannock
sqo	Sorkhei
sqq	Sou
sqr	Siculo Arabic
sqs	Sri Lankan Sign Language
sqt	اللغة السقطرية
squ	Squamish
sr	српски језик
sra	Saruga
srb	Sora
src	Logudorese Sardinian
sre	Sara
srf	Nafi
srg	Sulod
srh	塔吉克语
sri	Siriano
srk	Serudung Murut
srk-x-murutkabu	Murut Kabu
srl	Isirawa
sr-Latn	Serbian
srm	Saramaccan
srn	Sranan Tongo
sro	Campidanese Sardinian
srq	Sirionó
srr	Serer
srs	Sarsi
srt	Sauri
sru	Suruí
srv	Southern Sorsoganon
srx	Sirmauri
sry	Sera
srz	Shahmirzadi
ss	SiSwati
ssb	Southern Sama
ssb-x-simunulsam	Sama Simunul
ssc	Suba-Simbiti
ssc-x-kine	Kine
ssc-x-kiroba	Kiroba
ssc-x-sweta	Sweta
ssd	Siroi
sse	Balangingi
ssf	Thao
ssg	Seimat
ssh	لهجة قبيلة الشحوح
ssi	Sansi
ssj	Sausi
ssj-x-kene	Kene
ssj-x-wia	Wia
ssk	Sunam
ssl	Western Sisaala
ssm	Semnam
ssn	Waata
sso	Sissano
ssp	Spanish Sign Language
ssq	So'a
ssr	Swiss-French Sign Language
sss	Sô
sst	Sinasina
sst-x-dinga	Dinga
sst-x-gunangi	Gunangi
sst-x-kakora	Kakora
sst-x-kondo	Kondo
sst-x-malda	Malda
ssu	Susuami
ssv	Shark Bay
ssx	Samberigi
ssy	Saho
ssy-x-irob	Irob Saho
ssz	Sengseng
st	Sesotho
sta	Settla
stb	Northern Subanen
std	Sentinel
ste	Liana-Seti
stf	Seta
stg	Trieng
sth	Shelta
sti	Bulo Stieng
stj	Matya Samo
stk	Arammba
stl	Stellingwerfs
stm	Setaman
stn	Owa
stn-x-owariki	Owa Santa Catalina
stn-x-tawarafa	Tawarafa
sto	Stoney
stp	Southeastern Tepehuan
stq	Saterfriesisch
str	Straits Salish
sts	Shumashti
stt	Xtiêng
stu	Samtao
stv	Silt'e
stw	Satawalese
sty	Сибирско-татарский
su	Basa Sunda
sua	Sulka
sub	Suku
suc	Western Subanon
sud-x-sosudansl	South Sudan Sign Language
sue	Suena
sug	Suganga
sui	Suki
suj	Shubi
suk	Sukuma
sun-x-brebes	Brebes
suq	Suri
sur	Mwaghavul
sus	Susu
sut	Subtiaba
suv	Puroik
suw	Sumbwa
sux	Sumerian
suy	Suyá
suz	सुनुवार
sv	svenska
sva	ლუშნუ ნინ
svb	Ulau-Suain
svc	Vincentian Creole English
sve	Serili
svk	Slovakian Sign Language
svm	Slavomolisano
svr	Savara
svs	Savosavo
svx	Skalvian
sw	Kiswahili
swb	Maore Comorian
swc	Congo Swahili
swc-x-swamilitar	Military Swahili
swf	Sere
swg	Swabian
swh	Swahili (individual language)
swh-x-ngunya	Ngunya
swi	水语
swj	Sira
swk	Malawi Sena
swl	Swedish Sign Language
swm	Samosa
swo	Shanenawa
swp	Suau
swp-x-bonalua	Bonalua
swp-x-lausaha	Lausaha
swp-x-sinaki	Sinaki
swq	Sharwa
swr	Saweru
sws	Seluwasan
sws-x-makatian	Makatian
swt	Sawila
swu	Suwawa
swv	Shekhawati
sww	Sowa
swx	Suruahá
swy	Sarua
sxb	Suba
sxc	Sicanian
sxe	Sighu
sxg	旭米
sxk	Southern Kalapuya
sxl	Selian
sxm	Samre
sxn	Sangir
sxn-x-siau	Siau
sxn-x-tagula	Tagulandang
sxo	Sorothaptic
sxr	Saaroa
sxs	Sasaru
sxu	Upper Saxon
sxw	Saxwe Gbe
sya	Siang
sya-x-dayaksisang	Dayak Sisang
syb	Central Subanen
syc	Classical Syriac
syi	Seki
syk	Sukur
syl	Sylheti
sym	Maya Samo
syn	زبان سنایا
syo	Suoy
syr	ܠܫܢܐ ܣܘܪܝܝܐ
sys	Sinyar
syw	स्युबा
syx	Samay
syy	שפת הסימנים של שבט א-סייד
sza	Semelai
szb	Ngalum
szc	Semaq Beri
sze	Seze
szg	Kesengele
szl	Silesian
szn	Sula
szp	Suabo
szv	Isu (Fako Division)
szw	Sawai
ta	தமிழ்
taa	Lower Tanana
tab	Табасаранский
tac	Lowland Tarahumara
tac-x-bajatarahu	Baja Tarahumara
tad	Tause
tae	Tariana
taf	Tapirapé
tag	Tagoi
taj	Eastern Tamang
tak	Tala
tal	Tal
tam-LK-tamil	Tamil
tam-x-ahikunthakayo	कुरवाँ
tan	Tangale
tao	Yami
tap	Taabwa
taq	Tamasheq
tar	Central Tarahumara
tar-x-ralamuli	Ralamuli
tau	Upper Tanana
tav	Tatuyo
taw	Tai
tax	Tamki
tay	Atayal
taz	Tocho
tba	Aikanã
tbb	Tapeba
tbc	Takia
tbc-x-bunamruw	Bunam-ruw
tbc-x-megiar	Megiar
tbc-x-ruw	Ruw
tbd	Kaki Ae
tbe	Tanimbili
tbf	Mandara
tbg	North Tairora
tbg-x-abuhaina	Abuhaina
tbg-x-nanta	Nanta
tbi	Gaam
tbj	Tiang
tbk	Calamian Tagbanwa
tbl	Tboli
tbl-x-southtboli	Southern Tboli
tbl-x-taomohin	Tboli Tao Mohin
tbl-x-ubo	Ubo
tbm	Tagbu
tbn	Barro Negro Tunebo
tbo	Tawala
tbp	Taworta
tbp-x-airo	Airo
tbr	Tumtum
tbs	Tanguat
tbt	Tembo (Kitembo)
tbt-x-kirhinyihinyi	Kirhinyihinyi
tbv	Tobo
tbw	Tagbanwa
tbx	Kapin
tby	Tabaru
tbz	Ditammari
tca	Ticuna
tca-CO-ticuna	Ticuna
tcb	Tanacross
tcc	Datooga
tcd	Tafi
tce	Southern Tutchone
tcf	Malinaltepec Me'phaa
tcg	Tamagario
tch	Turks And Caicos Creole English
tci	Wára
tck	Tchitchege
tcl	Taman (Myanmar)
tcm	Tanahmerah
tcn	Tichurong
tco	Taungyo
tcp	Tawr Chin
tcq	Kaiy
tcs	Torres Strait Creole
tct	佯僙语
tcu	Southeastern Tarahumara
tcw	Tecpatlán Totonac
tcx	Toda
tcy	Tulu
tcy-x-koracha	Koracha
tcy-x-mavilan	Mavilan Tulu
tcz	Thado Chin
tda	Tagdal
tdb	Panchpargania
tdc	Emberá-Tadó
tdd	傣那语
tde	Tiranige Diga Dogon
tdf	Talieng
tdg	Western Tamang
tdh	Thulung
tdi	Tomadino
tdj	Tajio
tdk	Tambas
tdl	Sur
tdn	Tondano
tdn-x-kakas	Kakas
tdn-x-remboken	Remboken
tdo	Teme
tdq	Tita
tdr	Tơ-đrá
tds	Doutai
tdt	Tetun Dili
tdu	Tempasuk Dusun
tdv	Toro
tdx	Tandroy-Mahafaly Malagasy
tdx-x-antambahoka	Antambahoka
tdx-x-mahafaly	Mahafaly
tdy	Tadyawan
te	తెలుగు
tea	Temiar
tec	Terik
ted	Tepo Krumen
tee	Huehuetla Tepehua
tef	Teressa
teg	Teke-Tege
teh	Tehuelche
tei	Torricelli
tek	Ibali Teke
tek-x-mbankana	Teke Mbankana
tel-x-adebashaarya	Ade Basha Arya
tel-x-alba	Alba
tel-x-allami	Allami
tel-x-ardhan	Ardhan
tel-x-ardhi	Ardhi
tel-x-arttap	Arttap
tel-x-bagata	Bagata
tel-x-barda	Barda
tel-x-bestalu	Bestalu/Bastalu
tel-x-bheel	Bheel
tel-x-bhovi	Bhovi
tel-x-bommala	Bommala
tel-x-chamari	Chamari (Telugu)
tel-x-dasari	Dasari
tel-x-dhaba	Dhaba
tel-x-dhongri	Dhongri
tel-x-dudekula	Dudekula
tel-x-gamperukula	Gamperukula
tel-x-ganibasha	Ghani Bhasha
tel-x-gusavu	Gusavu
tel-x-jangalu	Telugu Jangalu
tel-x-kabasha	Kabasha
tel-x-kovi	Kovi
tel-x-onda	Onda
tel-x-orku	Orku
tel-x-osti	Osti
tel-x-otiya	Otiya
tel-x-pardhi	Pardhi (Telugu script)
tel-x-pichigunta	Phichiguntala
tel-x-piya	Piya
tel-x-pusala	Pusala
tel-x-sikaari	Sikaari
tel-x-telantelug	Telangana Telugu
tel-x-telingu	Telingu
tel-x-thakan	Thakan
tel-x-thalaboomi	Thalaboomi
tel-x-thoti	Thoti
tel-x-vadi	Vadi
tel-x-yauedhi	Yauedhi
tem	Timne
teo	Teso
teq	Temein
ter	Tereno
tes	Tengger
test	Lapaknon Manobo
tet	Tetum
tet-ID-southtetun	Tetun Selatan
teu	Soo
tev	Teor
tew	Tewa (USA)
tex	Tennet
te-x-bairag	Bairag
te-x-budugaja	Telugu Buduga Jangam
te-x-dokkalig	Dokka
te-x-dommara	Dommara
te-x-gangireddula	Gangireddula
te-x-kappalollu	Kapalollu
te-x-katipapalu	Katipapalu
te-x-muthrasi	Muthrasi
te-x-nakkalol	Nakkalollu
te-x-netaka	Nethakani
te-x-paidi	Paidi
te-x-pamuloll	Pamulollu
te-x-yeloru	Yeloru
tey	Tulishi
tfi	Tofin Gbe
tfn	Tanaina
tfo	Tefaro
tfr	Teribe
tft	Ternate
tg	тоҷикӣ, toçikī, تاجیکی‎
tga	Sagalla
tgb	Tobilung
tgc	Tigak
tgc-x-islandtiga	Tigak Island
tgd	Ciwogai
tge	Eastern Gorkha Tamang
tgf	Chalikha
tgh	Tobagonian Creole English
tgi	Lawunuia
tgj	Tagin
tgk-UZ-lyuli	Lyuli
tgn	Tandaganon
tgn-x-kadi	Kadi
tgo	Sudest
tgp	Tangoa
tgq	Tring
tgr	Tareng
tgs	Nume
tgt	Central Tagbanwa
tgu	Tanggu
tgu-x-ang	Ang
tgu-x-her	Her
tgv	Tingui-Boto
tgw	Tagwana Senoufo
tgx	Tagish
tgz	Tagalaka
th	ไทย
thc	Tai Hang Tong
thd	Thayore
the	मध्य क्षेत्रीय थारू
thf	Thangmi
thh	Northern Tarahumara
thi	Tai Long
thk	Tharaka
thl	Dangaura Tharu
thm	ภาษาข่าตองเหลือง
thn	Thachanadan
thp	Thompson
thq	मध्य-पूर्विया थारू
thr	Rana Tharu
ths	Thakali
tht	Tahltan
thu	Thuri
thv	تماهق
thw	Thudam
thy	Tha
thz	Tayart Tamajeq
ti	ትግርኛ
tia	Tidikelt Tamazight
tic	Tira
tid	Tidong
tid-x-menabursemido	Menabur Semido
tid-x-punanmabung	Punan Mabung
tid-x-punansemolon	Punan Semolon
tid-x-punantarau	Punan Tarau
tid-x-punantebunyau	Punan Tebunyau
tif	Tifal
tig	Tigre
tig-x-beniamrtig	Tigre Beni Amer
tih	Timugon Murut
tii	Tiene
tij	Tilung
tik	Tikar
tik-x-tigere	Tigere
tik-x-tigiere	Tigiere
tik-x-tikarkong	Tikar Kong
tik-x-tumu	Tumu
tim	Timbe
tin	Тиндинский
tio	Teop
tip	Trimuris
tiq	Tiéfo
tis	Masadiit Itneg
tis-x-abra	Abra Mabaka
tis-x-boliney	Boliney
tit	Tinigua
tiu	Adasen
tiv	Tiv
tiw	Tiwi
tix	Southern Tiwa
ti-x-eritra	Eritrean Tigrinya
tiy	Tiruray
tiz	红金傣语
tja	Tajuasohn
tjg	Tunjung
tji	土家语
tjl	Tai Laing
tjm	Timucua
tjo	تاشلحيت
tjs	土家语
tjw	Djabwurrung
tk	Türkmen, Түркмен
tka	Truká
tkb	Buksa
tkd	Tukudede
tke	Takwane
tkg	Tesaka Malagasy
tkl	Tokelau
tkm	Takelma
tkn	シマグチ
tkp	Tikopia
tkq	Tee
tkr	Saxur dili
tks	Takestani
tkt	Kathoriya Tharu
tku	Upper Necaxa Totonac
tkv	Mur Pano
tkw	Teanu
tkx	Tangko
tkz	Takua
tl	Wikang Tagalog
tla	Southwestern Tepehuan
tlb	Tobelo
tlc	Yecuatla Totonac
tld	Talaud
tlf	Telefol
tlg	Tofanma
tlh	Klingon
tli	Tlingit
tlj	Talinga-Bwisi
tlk	Taloki
tll	Tetela
tlm	Tolomako
tln	Talondo'
tlo	Talodi
tlp	Filomena Mata-Coahuitlán Totonac
tlq	Tai Loi
tlr	Talise
tlr-x-kuma	Kuma
tlr-x-riva	Riva
tlr-x-tolo	Tolo
tls	Tambotalo
tlt	Teluti
tlu	Tulehu
tlv	Taliabu
tlx	Khehek
tly	Talış dili
tma	Tama (Chad)
tmb	Katbol
tmc	Tumak
tmd	Haruai
tme	Tremembé
tmf	Toba-Maskoy
tmh	Tamashek
tmi	Tutuba
tmj	Samarokena
tmk	Northwestern Tamang
tml	Tamnim Citak
tmm	Tai Thanh
tmn	Dayak Taman Kapuas
tmn-x-dayaktamambaloh	Dayak Tamambaloh
tmn-x-nangataman	Dayak Nanga Taman
tmn-x-tamansesat	Taman Sesat
tmo	Temoq
tmp	Tai Mène
tmq	Tumleo
tmr	ארמית בבלית (ca. 200-1200 CE)
tms	Tima
tmt	Tasmate
tmu	Iau
tmv	Tembo (Motembo)
tmw	Temuan
tmy	Tami
tn	Setswana
tna	Tacana
tnb	Western Tunebo
tnc	Tanimuca-Retuarã
tnd	Angosturas Tunebo
tne	Tinoc Kallahan
tng	Tobanga
tnh	Maiani
tnh-x-gugubar	Gugubar
tnh-x-sereken	Sereken
tnh-x-wagimuda	Wagimuda
tni	Tandia
tnk	Kwamera
tnl	Lenakel
tnm	Tabla
tnm-x-yewena	Yewena
tnm-x-yokari	Yokari
tnn	North Tanna
tno	Toromono
tnp	Whitesands
tnq	Taino
tnr	Ménik
tns	Tenis
tnt	Tontemboan
tnu	Tay Khang
tnv	Tangchangya
tnw	Tonsawang
tnx	Tanema
tny	Tongwe
tnz	Ten'edn
to	faka Tonga
tob	Toba
toc	Coyutla Totonac
tod	Toma
tof	Gizrra
tog	Tonga (Nyasa)
toh	Gitonga
toi	Tonga
toi-x-tokaleya	Leya
toi-x-wee	Wee
toi-ZM-tonga	Tonga (Zambia)
toj	Tojolabal
tol	Tolowa
tom	Tombulu
tom-x-bahunt	Borgo Bahuntehu
tom-x-borgo	Borgo
too	Xicotepec De Juárez Totonac
top	Papantla Totonac
toq	Toposa
tor	Vara Banda
tor-x-togbobanda	Togbo Banda
tos	Highland Totonac
tou	Thổ
tov	Upper Taromi
tow	Jemez
tox	Tobian
toy	Topoiyo
toz	To
tpa	Taupota
tpc	Azoyú Me'phaa
tpe	Tippera
tpf	Tarpia
tpg	Kula
tpi	Tok Pisin
tpi-x-pngsl	Papua New Guinea Sign Language
tpj	Tapieté
tpk	Tupinikin
tpl	Tlacoapa Me'phaa
tpm	Tampulma
tpn	Tupinambá
tpo	Tai Pao
tpp	Pisaflores Tepehua
tpq	Tukpa
tpr	Tuparí
tpt	Tlachichilco Tepehua
tpu	Tampuan
tpv	Tanapag
tpw	Tupí
tpx	Acatepec Me'phaa
tpy	Trumai
tpz	Tinputz
tqb	Tembé
tql	Lehali
tqm	Turumsa
tqn	Tenino
tqo	Toaripi
tqo-x-kaipi	Kaipi
tqo-x-melaripi	Melaripi
tqp	Tomoip
tqq	Tunni
tqr	Torona
tqt	Western Totonac
tqu	Touo
tqw	Tonkawa
tr	Türkçe
tra	Tirahi
trb	Terebu
trc	Copala Triqui
trd	Turi
tre	East Tarangan
trf	Trinidadian Creole English
trg	יהודית-תימנית
trh	Turaka
tri	Trió
trj	Toram
trl	Traveller Scottish
trm	Tregami
trn	Trinitario
tro	Tarao Naga
trp	Kok Borok
trq	San Martín Itunyoso Triqui
trr	Taushiro
trs	Chicahuaxtla Triqui
trt	Tunggare
tru	ܛܘܪܝܐ
trv	Taroko
trw	توروالی
trx	Tringgus-Sembaan Bidayuh
trz	Torá
ts	Xitsonga
tsa	Tsaangi
tsb	Tsamai
tsc	Tswa
tsd	Tsakonian
tse	Tunisian Sign Language
tsg	Tausug
tsg-x-timurindel	Timur Indelio
tsh	Tsuvan
tsi	Tsimshian
tsj	Tshangla
tsk	Tseku
tsl	Ts'ün-Lao
tsm	Turkish Sign Language
tsp	Northern Toussian
tsq	Thai Sign Language
tsr	Akei
tsr-x-moiso	Moiso
tss	Taiwan Sign Language
tst	Tondi Songway Kiini
tsu	Tsou
tsv	Tsogo
tsw	Tsishingini
tsx	Mubami
tsy	Tebul Sign Language
tsz	Purepecha
tt	татар теле, tatar tele
tta	Tutelo
ttb	Gaa
ttc	Tektiteko
ttd	Tauade
ttd-x-aivara	Aivara
ttd-x-ivani	Ivani
ttd-x-pioro	Pioro
tte	Bwanabwana
ttf	Tuotomb
ttg	Tutong
tth	Upper Ta'oih
tti	Tobati
ttj	Tooro
ttk	Totoro
ttl	Totela
ttl-x-totelnamib	Totela (Namibia)
ttm	Northern Tutchone
ttn	Towei
tto	Lower Ta'oih
ttp	Tombelala
ttq	Tawallammat Tamajaq
ttq-x-ttwestniger	Tawellemmet
ttr	Tera
tts	Northeastern Thai
ttt	Tat dili
ttt-x-ismai	Ismaili
ttt-x-txizi	Xizi
ttu	Torau
ttv	Titan
ttw	Long Wat
tty	Sikaritai
ttz	Tsum
tua	Wiarumus
tub	Tübatulabal
tuc	Mutu
tud	Tuxá
tue	Tuyuca
tuf	Central Tunebo
tug	Tunia
tuh	Taulil
tui	Tupuri
tuj	Tugutil
tuk-x-levantin	Levantine Turkmen
tul	Tula
tum	Tumbuka
tum-x-chisenga	Chisenga
tum-x-yombe	Tumbuka Yombe
tun	Tunica
tuo	Tucano
tuq	Tedaga
tus	Tuscarora
tuv	Turkana
tuy	Tugen
tuz	Turka
tva	Vaghua
tvd	Tsuvadi
tvk	Southeast Ambrym
tvl	Tuvalu
tvm	Tela-Masbuar
tvn	Tavoyan
tvo	Tidore
tvs	Taveta
tvt	Tutsa Naga
tvu	Tunen
tvw	Sedoa
tw	Twi
twa	Twana
twb	Western Tawbuid
twc	Teshenawa
twd	Twents
twe	Tewa (Indonesia)
twe-x-lebang	Dayak Lebang
twf	Northern Tiwa
twg	Tereweng
twh	Tai Dón
twl	Tawara
twm	Tawang Monpa
twm-x-memba	Memba
twm-x-mompa	Mompa
twn	Twendi
two	Tswapong
twp	Ere
twq	Tasawaq
twr	Southwestern Tarahumara
twt	Turiwára
twu	Termanu
twu-x-keka	Keka
tww	Tuwari
twx	Tewe
twy	Tawoyan
txa	Tombonuo
txa-x-lingkabau	Lingkabau
txb	Tokharian B
txc	Tsetsaut
txe	Totoli
txg	Tangut
txh	Thracian
txi	Ikpeng
txj	Tarjumo
txm	Tomini
txn	West Tarangan
txo	Toto
txq	Tii
txq-x-loteletun	Loteletun
txr	Tartessian
txs	Tonsea
txt	Citak
txu	Kayapó
txx	Tatana
txy	Tanosy Malagasy
ty	Reo Tahiti
tya	Tauya
tya-x-kausi	Kausi
tya-x-pukesi	Pukesi
tye	Kyanga
tyh	Ơ Đu
tyi	Teke-Tsaayi
tyj	Tai Do
tyl	Thu Lao
tyn	Kombai
tyn-x-kombateyan	Kombai Teyan
tyn-x-ringgalela	Kombai Ringgalela
tyr	Táy-Môc-Châu
tys	Tày Sa Pa
tyt	Tày Tấc
tyu	Kua
tyv	Тувинский
tyx	Teke-Tyee
tyy	Tiyaa
tyz	Tiếng Tày
tza	Tanzanian Sign Language
tzc	tsotzil
tzh	Tzeltal
tzh-x-oxchuctzeltal	Tzeltal de Oxchuc
tzh-x-tenejapa	Tzeltal de Tenejapa
tzj	Tz'utujil
tzl	Talossan
tzm	ⵜⴰⵎⴰⵣⵉⵖⵜ
tzn	Tugun
tzo	Tzotzil
tzo-x-chalchihuitan	Tzotzil de Chalchihuitan
tzo-x-chenalho	Tzotzil de Chenalhó
tzo-x-huixtan	Tzotzil de Huixtan
tzx	Tabriak
uam	Uamué
uan	Kuan
uar	Tairuma
uba	Ubang
ubi	Ubi
ubl	Buhi'non Bikol
ubr	Ubir
ubu	Umbu-Ungu
ubu-x-kambiya	Kambiya
uda	Uda
ude	Удэгейский
udg	Muduga
udi	Udi dili
udj	Ujir
udl	Wuzlam
udm	Удмуртский
udm-x-norudmurt	Northern Udmurt
udu	Uduk
ues	Kioko
ufi	Ufim
ug	ئۇيغۇرچە‎, 维吾尔语, Уйгурский язык
uga	Ugaritic
uge	Ughele
ugn	Ugandan Sign Language
ugn-x-rwandansl	Rwandan Sign Language
ugo	Ugong
ugy	Uruguayan Sign Language
uha	Uhami
uhn	Damal
uis	Uisai
uiv	Iyive
uji	Tanjijili
uk	українська мова
uka	Kaburi
ukg	Ukuriguma
ukh	Ukhwejo
uki	କୁଇ
ukl	Ukrainian Sign Language
ukp	Ukpe-Bayobiri
ukq	Ukwa
uks	Urubú-Kaapor Sign Language
uku	Ukue
ukv	Kuku
ukw	Ukwuani-Aboh-Ndoni
ula	Fungwa
ulb	Ulukwumi
ulc	Ульчский
ule	Lule
ulf	Usku
uli	Ulithian
ulk	Meriam
ull	Ullatan
ulm	Ulumanda'
uln	Unserdeutsch
ulu	Uma' Lung
ulw	Ulwa
uma	Umatilla
umb	Umbundu
umc	Marrucinian
umi	Ukit
umm	Umon
umn	Makyan Naga
umo	Umotína
ump	Umpila
ums	Pendau
umu	Munsee
una	North Watut
und	Undetermined
une	Uneme
ung	Ngarinyin
unk	Enawené-Nawé
unm	Unami
unn	Kurnai
unr	Mundari
unu	Unubahe
unx	Munda
unz	Unde Kaili
upi	Umeda
upv	Uripiv-Wala-Rano-Atchin
upv-x-inam	Inam
upv-x-naledo	Nale Do
upv-x-naletojan	Nale Tojan
upv-x-ndzave	Nzdave
ur	اردو
ura	Urarina
urb	Urubú-Kaapor
ur-Deva	Urdu Devanagari script
ure	Uru
urg	Urigina
urg-x-ohjob	Ohjob
urg-x-undi	Undi
urh	Urhobo
uri	Urim
urk	Urak Lawoi'
url	Urali
urm	Urapmin
urn	Uruangnirin
uro	Ura (Papua New Guinea)
urp	Uru-Pa-In
urr	Lehalurup
urt	Urat
urw	Sop
urw-x-kono	Kono
urw-x-maling	Maling
urw-x-onee	Onee
urx	Urimo
ur-x-dcv	اردو - Dominant Culture Variant
ury	Orya
ury-x-oryataja	Orya-Taja
urz	Uru-Eu-Wau-Wau
usa	Usarufa
ush	اشوجی
usi	Usui
usk	Usaghade
usp	Uspanteco
uss	us-Saare
usu	Uya
uta	Otank
ute	Ute-Southern Paiute
uth	ut-Hun
utp	Amba (Solomon Islands)
utr	Etulo
utu	Utu
utu-x-ivap	Ivap
uum	Урумский язык
uur	Ura (Vanuatu)
uuu	濮满
uve	West Uvean
uvh	Uri
uvl	Lote
uwa	Kuku-Uwanh
uya	Doko-Uyanga
uz	Oʻzbek, Ўзбек, أۇزبېك‎
uzn	Northern Uzbek
uzs	ازبېک تیلی
vaa	Vaagri Booli
vaa-x-akkipikki	Akki Pikki
vaa-x-konaakki	Kona-Akki Pikki
vae	Vale
vaf	گویش وفسی
vag	Vagla
vah	Varhadi-Nagpuri
vai	Vai
vaj	Sekele
val	Vehes
vam	Vanimo
van	Valman
vao	Vao
vap	Vaiphei
var	Huarijio
vas	Vasavi
vau	Vanuma
vav	Varli
vay	वायु
vbb	Southeast Babar
vbk	Southwestern Bontok
ve	Tshivenḓa
vec	Venetian
ved	Veddah
vel	Veluws
vem	Vemgo-Mabas
ven-ZW-venda	Venda
veo	Ventureño
vep	Вепсский
ver	Mom Jango
ver-x-vere	Vere
vgr	Vaghri
vgt	Vlaamse Gebarentaal
vi	Tiếng Việt
vic	Virgin Islands Creole English
vid	Vidunda
vif	Vili
vig	Viemo
vin	Vinza
vis	Vishavan
vit	Viti
viv	Iduna
vki	Ija-Zuba
vkj	Kujargé
vkk	Kaur
vkl	Kulisusu
vkn	Koro Nulu
vko	Kodeoha
vkp	Korlai Creole Portuguese
vkt	Tenggarong Kutai Malay
vku	Kurrama
vkz	Koro Zuba
vlp	Valpei
vls	Vlaams
vma	Martuyhunira
vmc	Juxtlahuaca Mixtec
vmd	Mudu Koraga
vme	East Masela
vmf	Mainfränkisch
vmg	Lungalunga
vmh	Maraghei
vmj	Ixtayutla Mixtec
vmk	Makhuwa-Shirima
vmm	Mitlatongo Mixtec
vmp	Soyaltepec Mazatec
vmq	Soyaltepec Mixtec
vmr	Marenje
vmw	Makhuwa
vmw-x-nahara	Makhuwa Nahara
vmx	Tamazola Mixtec
vmy	Ayautla Mazatec
vmz	Mazatlán Mazatec
vnk	Vano
vnm	Vinmavis
vnp	Vunapu
vo	Volapük
vor	Voro
vot	Водский
vra	Vera'a
vro	Võro
vrs	Varisi
vrt	Burmbar
vsi	Moldova Sign Language
vsl	Venezuelan Sign Language
vsv	Valencian Sign Language
vto	Vitou
vum	Vumbu
vun	Vunjo
vut	Vute
vwa	阿佤方言 (China)
wa	walon
waa	Walla Walla
wab	Wab
wac	Wasco-Wishram
wad	Wandamen
wae	Walser
waf	Wakoná
wag	Wa'ema
wah	Watubela
wai	Wares
waj	Waffa
wal	Wolaytta
wam	Wampanoag
wan	Wan
wao	Wappo
wap	Wapishana
waq	Wageman
war	Waray (Philippines)
was	Washo
wat	Kaninuwa
wau	Waurá
wav	Waka
waw	Waiwai
wax	Watam
way	Wayana
waz	Wampur
wba	Warao
wbb	Wabo
wbe	Waritai
wbf	Wara
wbh	Wanda
wbi	Vwanji
wbj	Alagwa
wbk	Kalaṣa-alâ
wbl	Khikwor
wbm	佤方言
wbp	Warlpiri
wbq	Waddar
wbq-x-kusburva	Kusbur Vadar
wbr	Wagdi
wbs	West Bengal Sign Language
wbt	Wanman
wbv	Wajarri
wbw	Woi
wbw-x-woinap	Woinap
wca	Yanomámi
wci	Waci Gbe
wdd	Wandji
wdg	Wadaginam
wdj	Wadjiginy
wec	Wè Western
wed	Wedau
weg	Wergaia
weh	Weh
wei	Kiunum
wem	Weme Gbe
weo	Wemale
wep	Westphalien
wer	Weri
wes	Cameroon Pidgin
wet	Perai
weu	Rawngtu Chin
weu-x-lawngtu	Lawng Tu
wew	Wejewa
wew-x-ede	Ede
wew-x-loli	Loli
wfg	Yafi
wgb	Wagawaga
wgi	Wahgi
wgi-x-kumai	Kumai
wgo	Waigeo
wgu	Wirangu
wgy	Warrgamay
wha	Manusela
whg	North Wahgi
whk	Wahau Kenyah
whk-x-amaktimei	Kenyah Amak Ti Mei
whk-x-lebukulit	Lebu' Kulit
whk-x-longpulung	Long Pulung
whu	Wahau Kayan
wib	Southern Toussian
wic	Wichita
wig	Wik-Ngathana
wih	Wik-Me'anha
wii	Minidien
wij	Wik-Iiyanh
wik	Wikalkan
wim	Wik-Mungkan
win	Ho-Chunk
wiu	Wiru
wiv	Vitu
wiy	Wiyot
wja	Waja
wji	Warji
wkb	Kumbaran
wkd	Wakde
wkl	Kalanadi
wku	Kunduvadi
wkw	Wakawaka
wla	Walio
wlc	Mwali Comorian
wle	Wolane
wlg	Kunbarlang
wli	Waioli
wli-x-tiana	Tiana
wll	Wali (Sudan)
wlm	Middle Welsh
wlo	Wolio
wlr	Wailapa
wls	Wallisian
wlv	Wichí Lhamtés Vejoz
wlw	Walak
wlx	Wali (Ghana)
wmb	Wambaya
wmc	Wamas
wmd	Mamaindé
wme	वाम्बुले
wmh	Waima'a
wmm	Maiwa (Indonesia)
wmo	Wom (Papua New Guinea)
wms	Wambon
wms-x-senggawop	Wambon Senggawop
wms-x-wambonsait	Wambon Sait
wmt	Walmajarri
wmw	Mwani
wmx	Womo
wnb	Wanambre
wnc	Wantoat
wne	ونیسی
wng	Wanggom
wni	Ndzwani Comorian
wnk	Wanukaka
wno	Wano
wnp	Wanap
wnu	Usan
wnw	Wintu
wny	Wanyi
wo	Wollof
woa	Tyaraity
wob	Wè Northern
woc	Wogeo
wod	Wolani
woe	Woleaian
wof	Gambian Wolof
wog	Wogamusin
woi	Kamang
woi-x-suboo	Suboo
wok	Longto
wom	Wom (Nigeria)
won	Wongo
won-x-logondjo	Logondjo
woo	Manombai
wor	Woria
wos	Hanga Hundi
wow	Wawonii
woy	Weyto
wpc	Maco
wra	Warapu
wrd	Warduji
wrg	Warungu
wrh	Wiradhuri
wrk	Garrwa
wrl	Warlmanpa
wrm	Warumungu
wrn	Warnang
wro	Worrorra
wrp	Waropen
wrr	Wardaman
wrs	Waris
wru	Waru
wrv	Waruna
wrx	Wae Rana
wry	Merwari
wsa	Warembori
wsg	Adilabad Gondi
wsi	Wusi
wsk	Waskia
wsk-x-kaul	Kaul
wsk-x-makitu	Makitu
wsk-x-samoan1	Samoan 1
wsk-x-sipiram	Sipiram
wsk-x-urugen	Urugen
wsr	Owenia
wss	Wasa
wsu	Wasu
wtf	Watiwa
wtf-x-musuam	Musuam
wti	Berta
wtk	Watakataui
wtm	Mewati
wtw	Wotu
wua	Wikngenchera
wub	Wunambal
wud	Wudu
wuh	五屯话
wul	Silimo
wum	Wumbvu
wun	Bungu
wut	Wutung
wut-x-hofi	Hofi
wuu	吳語
wuv	Wuvulu-Aua
wux	Wulna
wuy	Wauyai
wwa	Waama
wwo	Wetamut
www	Wawa
wxa	瓦乡话
wya	Wyandot
wyb	Wangaaybuwan-Ngiyambaa
wym	Wymysorys
wyr	Wayoró
wyy	Western Fijian
wyy-x-nabila	Nabila
wyy-x-nadi	Nadi
wyy-x-nadroga	Nadroga
wyy-x-rakiraki	Rakiraki
wyy-x-tavua	Tavua
-x-	Amarenga y'Ikinyarwanda
xaa	Andalusian Arabic
xab	Sambe
xac	Kachari
xad	Adai
xae	Aequian
xag	Aghwan
xai	Kaimbé
xal	Калмыцкий
xan	Xamtanga
xao	Khao
xap	Apalachee
xaq	Aquitanian
xat	Katawixi
xau	Kauwera
xav	Xavánte
xaw	Kawaiisu
xay	Kayan Mahakam
xba	Kamba (Brazil)
xbb	Lower Burdekin
xbc	Bactrian
xbi	Kombio
xbm	Middle Breton
xbn	Kenaboi
xbo	Bolgarian
xbr	Kambera
xbr-x-lenang	Lenang
xbw	Kambiwá
xby	Batyala
xcb	Cumbric
xcc	Camunic
xce	Celtiberian
xcg	Cisalpine Gaulish
xch	Chemakum
xcl	Classical Armenian
xcm	Comecrudo
xcn	Cotoname
xco	Chorasmian
xcr	Carian
xct	Classical Tibetan
xcu	Curonian
xcv	Chuvantsy
xcw	Coahuilteco
xcy	Cayuse
xda	Darkinyung
xdc	Dacian
xdm	Edomite
xdy	Malayic Dayak
xdy-x-airdurian	Dayak Air Durian
xdy-x-balai	Balai
xdy-x-bangaemoro	Dayak Bangae' Moro
xdy-x-batangbelian	Dayak Batang Belian
xdy-x-batangkawa	Batang Kawa
xdy-x-batupayung	Dayak Batu Payung
xdy-x-belantika	Belantikan
xdy-x-belantikan	Dayak Belantikan
xdy-x-benawas	Benawas
xdy-x-dayakayrupas	Dayak Air Upas
xdy-x-dayakbaya	Dayak Baya
xdy-x-dayakbuket	Dayak Dayak Buket
xdy-x-dayakdelang	Dayak Delang
xdy-x-dayakensilat	Dayak Ensilat
xdy-x-dayakkayung	Dayak Kayung
xdy-x-dayakkrio	Dayak Krio
xdy-x-dayaklau	Dayak Lau
xdy-x-dayaklaur	Dayak Laur
xdy-x-dayakloksado	Dayak Loksado
xdy-x-dayakmembulu	Dayak Membulu'
xdy-x-dayakmentobi	Dayak Mentobi
xdy-x-dayakmongko	Dayak Mongko
xdy-x-dayakpangin	Dayak Pangin
xdy-x-dayakpawatn	Dayak Pawatn
xdy-x-dayakpayak	Dayak Payak
xdy-x-dayakpunti	Dayak Punti
xdy-x-dayakpunuk	Dayak Punuk
xdy-x-dayakriam	Dayak Riam
xdy-x-dayakserawai	Dayak Serawai
xdy-x-dayaksuruk	Dayak Suruk
xdy-x-dayaktebidah	Dayak Tebidah
xdy-x-dayaktola	Dayak Tola
xdy-x-delang	Delang
xdy-x-gerungang	Dayak Gerungang
xdy-x-ingarsilat	Dayak Ingar Silat
xdy-x-jungkal	Dayak Jungkal
xdy-x-kantu	Dayak Kantu
xdy-x-karabat	Dayak Karabat
xdy-x-kayong	Dayak Kayong
xdy-x-kebuai	Dayak Kebuai
xdy-x-kemuning	Dayak Kemuning
xdy-x-kengkubang	Dayak Kengkubang
xdy-x-lamandau	Lemandau
xdy-x-lemandau	Dayak Lemandau
xdy-x-maamp	Dayak Maamp
xdy-x-mahawa	Dayak Mahawa
xdy-x-manggaling	Dayak Manggaling
xdy-x-marausinar	Dayak Marau Sinar Bulan
xdy-x-marautempay	Dayak Marau Tempayak
xdy-x-melahui	Dayak Melahui
xdy-x-mentaya	Mentaya
xdy-x-mentebah	Dayak Mentebah
xdy-x-mentobi	Mentobi
xdy-x-ollamelahui	Dayak Olla Melahui
xdy-x-parangkunyit	Dayak Parangkunyit
xdy-x-parenggean	Parenggean
xdy-x-payakpapak	Dayak Payak Papak
xdy-x-pelanjau	Dayak Pelanjau
xdy-x-pengancing	Dayak Pengancing
xdy-x-pengatapan	Dayak Pengatapan
xdy-x-perigiq	Dayak Perigiq
xdy-x-peringkunyit	Dayak Peringkunyit
xdy-x-pesangaran	Dayak Pesangaran
xdy-x-petebang	Dayak Petebang
xdy-x-putaran	Dayak Putaran
xdy-x-randaujoka	Dayak Randau Joka
xdy-x-sawe	Dayak Sawe
xdy-x-sekakai	Dayak Sekakai
xdy-x-semanak	Dayak Semanak
xdy-x-senduruhan	Dayak Senduruhan
xdy-x-sepauhan	Dayak Sepauhan
xdy-x-serengkah	Dayak Serengkah
xdy-x-songkap	Dayak Songkap
xdy-x-suangensilat	Dayak Suang Ensilat
xdy-x-suhaid	Dayak Suhaid
xdy-x-sukamara	Dayak Sukamara
xdy-x-sumanjawat	Dayak Sumanjawat
xdy-x-tamuan	Dayak Tamuan
xdy-x-undau	Dayak Undau
xeb	Eblan
xed	Hdi
xeg	Batwa
xel	Kelo
xem	Kembayan
xem-x-baope	Dayak Baope
xem-x-dayakgolik	Dayak Golik
xem-x-hibun	Hibun
xem-x-karambai	Dayak Karambai
xem-x-sekayam	Dayak Sekayam
xep	Epi-Olmec
xer	Xerénte
xes	Kesawai
xes-x-korumu	Korumu
xet	Xetá
xeu	Keoru-Ahia
xfa	Faliscan
xga	Galatian
xgb	Gbin
xgf	Gabrielino-Fernandeño
xgl	Galindan
xgr	Garza
xgu	Unggumi
xh	isiXhosa
xha	Harami
xhc	Hunnic
xhd	Hadrami
xhe	Khetrani
xhr	Hernican
xht	Hattic
xhu	Hurrian
xhv	Khua
xib	Iberian
xii	Xiri
xil	Illyrian
xir	Xiriâna
xis	Kisan
xiv	Indus Valley Language
xiy	Xipaya
xka	کلکوٹی
xkb	Northern Nago
xkc	گویش خوئینی
xkd	Mendalam Kayan
xke	Kereho
xkf	Khengkha
xkg	Gworog
xkh	Karahawyana
xki	Kenyan Sign Language
xkj	Kajali
xkk	Kaco'
xkl	Mainstream Kenyah
xkl-x-badeng	Badeng
xkl-x-bakung	Dayak Bakung
xkl-x-dayakagabag	Dayak Agabag
xkl-x-lepokbakung	Lepok Bakung
xkl-x-lepokbemi	Lepok Bemi
xkl-x-lepoke	Lepo' Ke
xkl-x-lepokjalan	Lepok Jalan
xkl-x-lepokkulit	Lepok Kulit
xkl-x-lepoktou	Lepok Tou
xkl-x-lepomaut	Lepo Ma'ut
xkl-x-lepotepu	Lepo Tepu
xkl-x-longjalan	Long Jalan
xkl-x-longlake	Long Lake
xkl-x-ndang	Lepo Ndang
xkl-x-umatukung	Kenya Uma Tukung
xkn	Kayan River Kayan
xkn-x-dayakkayaan	Dayak Dayak Kayaan
xkn-x-kayan	Dayak Kayan
xkn-x-umaapan	Kayan Uma Apan
xkn-x-umalekan	Kayan Uma Lekan
xko	Kiorr
xkp	Kabatei
xkq	Koroni
xkr	Xakriabá
xks	Kumbewaha
xkt	Kantosi
xku	Kaamba
xkv	Kgalagadi
xkw	Kembra
xkx	Karore
xky	Uma' Lasan
xky-x-longnyau	Long Nyau
xky-x-umaalim	Dayak Uma' Alim
xkz	Kurtokha
xla	Kamula
xlb	Loup B
xlc	Lycian
xld	Lydian
xle	Lemnian
xlg	Ligurian (Ancient)
xli	Liburnian
xln	Alanic
xlo	Loup A
xlp	Lepontic
xls	Lusitanian
xlu	Cuneiform Luwian
xly	Elymian
xma	Mushungulu
xmb	Mbonga
xmc	Makhuwa-Marrevone
xmd	Mbudum
xme	Median
xmf	მარგალური ნინა
xmg	Mengaka
xmh	Kuku-Muminh
xmj	Majera
xmk	Ancient Macedonian
xml	Malaysian Sign Language
xml-x-sibi	SIBI
xmm	Manado Malay
xmm-x-borgo	Borgo Malay
xmn	Manichaean Middle Persian
xmo	Morerebi
xmr	Meroitic
xms	Moroccan Sign Language
xmt	Matbat
xmv	Antankarana Malagasy
xmw	Tsimihety Malagasy
xmx	Maden
xmz	Mori Bawah
xna	Ancient North Arabian
xnb	Kanakanabu
xng	Middle Mongolian
xnh	宽语
xni	Ngarigu
xnn	Northern Kankanay
xno	Anglo-Norman
xnr	Kangri
xns	Kanashi
xnt	Narragansett
xny	Nyiyaparli
xnz	Kenzi
xod	Kokoda
xog	Soga
xog-x-lukono	Lukono
xog-x-lulamogi	Lulamogi
xog-x-lusiki	Lusiki
xoi	Kominimung
xok	Xokleng
xom	Komo (Sudan)
xom-x-thawadaway	Thawad Awayr
xon	Konkomba
xon-x-komba	Komba
xoo	Xukurú
xop	Kopar
xor	Korubo
xow	Kowaki
xpc	Pecheneg
xpe	Liberia Kpelle
xpg	Phrygian
xpi	Pictish
xpk	Kulina Pano
xpm	Pumpokol
xpn	Kapinawá
xpo	Pochutec
xpp	Puyo-Paekche
xpq	Mohegan-Pequot
xpr	Parthian
xps	Pisidian
xpu	Punic
xpy	Puyo
xqa	Karakhanid
xqt	Qatabanian
xra	Krahô
xrb	Eastern Karaboro
xri	Krikati-Timbira
xrm	Armazic
xrn	Arin
xrr	Raetic
xrt	Aranama-Tamique
xru	Marriammu
xrw	Karawa
xsa	Sabaean
xsb	Sambal
xsc	Scythian
xsd	Sidetic
xse	Sempan
xsh	Shamang
xsi	Sio
xsj	Subi
xsl	South Slavey
xsm	Kasem
xsn	Sanga (Nigeria)
xso	Solano
xsp	Silopi
xsp-x-sawaru	Sawaru
xsq	Makhuwa-Saka
xsr	शेर्पा
xsr-x-shyarpa	Shyarpa
xss	Assan
xsu	Sanumá
xsv	Sudovian
xsy	Saisiyat
xta	Alcozauca Mixtec
xtb	Chazumba Mixtec
xtc	Katcha-Kadugli-Miri
xtd	Diuxi-Tilantongo Mixtec
xte	Ketengban
xtg	Transalpine Gaulish
xth	Yitha Yitha
xti	Sinicahua Mixtec
xtj	San Juan Teita Mixtec
xtl	Tijaltepec Mixtec
xtm	Magdalena Peñasco Mixtec
xtn	Northern Tlaxiaco Mixtec
xto	Tokharian A
xtp	San Miguel Piedras Mixtec
xtq	Tumshuqese
xtr	Early Tripuri
xts	Sindihui Mixtec
xtt	Tacahua Mixtec
xtu	Cuyamecalco Mixtec
xtw	Tawandê
xty	Yoloxochitl Mixtec
xtz	Tasmanian
xua	Alu Kurumba
xub	Betta Kurumba
xud	Umiida
xug	山原言葉
xuj	Jennu Kurumba
xum	Umbrian
xuo	Kuo
xup	Upper Umpqua
xur	Urartian
xuu	Kxoe
xuu-x-kwedam	Kwedam
xve	Venetic
xvi	کامويري
xvn	Vandalic
xvo	Volscian
xvs	Vestinian
xwa	Kwaza
xwc	Woccon
xwd	Wadi Wadi
xwe	Xwela Gbe
xwg	Kwegu
xwk	Wangkumara
xwl	Western Xwla Gbe
xwo	Written Oirat
xwr	Kwerba Mamberamo
xxb	Boro (Ghana)
xxk	Ke'o
xxm	Minkin
xxt	Tambora
xyl	Yalakalore
xyy	Yorta Yorta
xzh	Zhang-Zhung
xzm	Zemgalian
xzp	Ancient Zapotec
yaa	Yaminahua
yab	Yuhup
yac	Pass Valley Yali
yad	Yagua
yae	Pumé
yaf	Yaka (Democratic Republic of Congo)
yaf-x-mikagnya	Mikagnya
yag	Yámana
yah	Yazgulyam
yai	Yagnobi
yaj	Banda-Yangere
yak	Yakama
yal	Yalunka
yam	Yamba
yan	Mayangna
yan-HN-tawahaka	Placeholder Language
yan-x-tawahaka	Tawahaka
yao	Yao
yap	Yapese
yaq	Yaqui
yar	Yabarana
yas	Nugunu (Cameroon)
yat	Yambeta
yat-x-nedeck	Nedeck
yau	Yuwana
yav	Yangben
yaw	Yawalapití
yax	Yauma
yay	Agwagwune
yaz	Lokaa
yba	Yala
ybb	Yemba
ybe	西部裕固语
ybh	Yakha
ybi	Yamphu
ybj	Hasha
ybk	Bokha
ybl	Yukuben
ybm	Yaben
ybn	Yabaâna
ybo	Yabong
ybo-x-baded	Baded
ybo-x-basor	Basor
ybo-x-mase	Mase
ybo-x-yaugang	Yaugang
ybx	Yawiyo
yby	Yaweyuha
ych	车苏
ycl	倮倮泼
ycn	Yucuna
ycp	Chepya
yda	Yanda
ydd	יידיש המזרחי
yde	Yangum Dey
ydg	یدغہ
ydk	Yoidik
ydk-x-iyaqnam	Iyaqnam
ydk-x-wasabwara	Wasab Wara
ydk-x-yab	Yab
yea	Ravula
yec	Yeniche
yee	Yimas
yej	יווניטיקה
yel	Yela
yer	Tarok
yes	Nyankpa
yet	Yetfa
yeu	Yerukula
yeu-x-kunche	Kuncherukala
yev	Yapunda
yey	Yeyi
ygl	Yangum Gel
ygm	Yagomi
ygp	葛泼语
ygr	Yagaria
ygr-x-huwa	Arokara
ygr-x-iyau	Kimi
ygs	Yolŋu Sign Language
ygu	Yugul
ygw	Yagwoia
yha	巴哈语
yhd	עיראקית יהודית
yhd-x-judeoarabic	عربية يهودية
yhl	Hlepho Phowa
yhs	Yan-nhaŋu Sign Language
yi	ייִדיש
yia	Yinggarda
yif	阿车
yig	乌撒纳苏语
yih	Western Yiddish
yii	Yidiny
yij	Yindjibarndi
yik	东山坝腊罗语
yim	Yimchungru Naga
yin	Yinchia
yip	Pholo
yiq	密察
yir	North Awyu
yis	Yis
yit	东腊鲁语
yiu	阿鲁
yiu-x-long	Long
yiv	北尼苏语
yix	阿细
yiz	阿哲
yka	Yakan
ykg	Северноюкагирский
yki	Yoke
ykk	Yakaikeke
ykl	Khlula
ykm	Kap
ykn	跨恩斯话
yko	Yasa
ykr	Yekora
ykt	嘎苏话
yku	跨玛斯话
yky	Yakoma
yla	Yaul
ylb	Yaleba
yle	Yele
ylg	Yelogu
yli	Angguruk Yali
yll	Yil
ylm	Limi
yln	郎念布央语
ylo	纳罗
ylu	Aribwaung
yly	Nyâlayu
ymb	Yambes
ymc	Southern Muji
ymc-x-huamuji	Hua Muji
ymd	木达
ymg	Yamongeri
ymh	Mili
ymi	Moji
ymk	Makwe
yml	Iamalele
ymm	Maay
ymn	Yamna
ymo	Yangum Mon
ymp	Yamap
ymq	Qila Muji
ymq-x-midiqi	Midi Qi Muji
ymr	Malasar
yms	Mysian
ymx	Northern Muji
ymz	Muzi
yna	阿罗语
yne	拉乌
yng	Yango
ynk	Наука́нский
ynl	Yangulam
ynl-x-buram	Buram
ynn	Yana
yno	Yong
ynq	Yendang
yns	Yansi
yns-x-kiangi	Kiangi
ynu	Yahuna
yo	Yorùbá
yog	Yogad
yoi	与那国物言
yok	Yokuts
yol	Yola
yom	Yombe
yon	Yongkom
yor-x-ilaje	Ilaje
yor-x-ondo	Ondo
yot	Yotti
yox	ユンヌフトゥバ
yoy	Yoy
ypa	Phala
ypb	Labo Phowa
ypg	Phola
yph	Phupha
ypm	Phuma
ypn	Ani Phowa
ypo	Alo Phola
ypp	Phupa
ypp-x-pucu	Pucu
ypz	Phuza
yra	Yerakai
yrb	Yareba
yrb-x-rarafa	Rarafa
yre	Yaouré
yri	Yarí
yrk	Ненецкий
yrl	Nhengatu
yrm	Yirrk-Mel
yrn	雅郎布央语
yrs	Yarsun
yrw	Yarawata
yry	Yarluyandi
ysc	Yassic
ysd	撒慕
ysg	锁内嘎话
ysl	Yugoslavian Sign Language
ysn	撒尼
yso	基諾語 (China)
yso-x-lolo	Lo Lo
ysp	南倮倮泼语
yss	Yessan-Mayo
ysy	白彝
yta	他鲁
ytl	堂郎语
ytp	Thopho
ytw	Yout Wam
yty	Yatay
yua	Yucateco
yuc	Yuchi
yud	טריפוליטאית יהודית
yue	粵語
yue-x-xaphang	Xa Phang
yuf	Havasupai-Walapai-Yavapai
yug	Югский
yui	Yurutí
yuj	Karkar-Yuri
yuk	Yuki
yul	Yulu
yum	Quechan
yun	Ɓəna (Nigeria)
yup	Yukpa
yuq	Yuqui
yur	Yurok
yut	Yopno
yuw	Yau (Morobe Province)
yux	Южноюкагирский
yuy	东部裕固语
yuz	Yuracare
yva	Yawa
yvt	Yavitero
ywa	Kalou
ywg	Yinhawangka
ywl	腊罗
ywn	Yawanawa
ywq	武禄彝语
ywq-x-hongyi	Hong Yi
ywq-x-nasunan	Nasunan Yi
ywq-x-tusiyi	Tusi Yi
ywr	Yawuru
ywt	中腊罗语
ywt-x-datusiyi	Datusi Yi
ywu	乌蒙纳苏语
yxl	Yardliyawarra
yxm	Yinwum
yxu	Yuyu
yyr	Yir Yoront
yyu	Yau (Sandaun Province)
yyz	阿夷子
yzg	峨马布央语
yzk	Zokhuo
za	Saɯ cueŋƅ, Saw cuengh
zaa	Sierra de Juárez Zapotec
zab	San Juan Guelavía Zapotec
zac	Ocotlán Zapotec
zad	Cajonos Zapotec
zae	Yareni Zapotec
zaf	Ayoquesco Zapotec
zag	Zaghawa
zah	Zangwal
zai	Isthmus Zapotec
zaj	Zaramo
zak	Zanaki
zal	柔若
zam	Miahuatlán Zapotec
zao	Ozolotepec Zapotec
zap	Zapotec
zaq	Aloápam Zapotec
zar	Rincón Zapotec
zas	Santo Domingo Albarradas Zapotec
zat	Tabaa Zapotec
zau	Zangskari
zav	Yatzachi Zapotec
zaw	Mitla Zapotec
zax	Xadani Zapotec
zay	Zayse-Zergulla
zay-x-zergulla	Zergulla
zaz	Zari
zbc	Central Berawan
zbe	East Berawan
zbe-x-dayakbenawas	Dayak Benawas
zbl	Blissymbols
zbt	Batui
zbu	Buu
zbw	West Berawan
zca	Coatecas Altas Zapotec
zch	中紅水河壯語
zdj	Ngazidja Comorian
zea	Zeeuws
zeg	Zenag
zeh	红水河
zen	Zenaga
zga	Kinga
zga-x-mahanji	Mahanji
zgb	桂北
zgh	ⵜⴰⵎⴰⵣⵉⵖⵜ ⵜⴰⵏⴰⵡⴰⵢⵜ
zgm	民讲
zgn	桂边
zgr	Magori
zh	中文 (Zhōngwén), 汉语, 漢語
zha-x-chineseoralversion	Chinese Oral Version
zhb	扎坝语
zhd	文马
zhi	Zhire
zhn	砚广
zho-x-chinoral	Oral Chinese
zho-x-writtencov	Written Chinese Oral Version
zh-tw	繁體中文
zhw	Zhoa
zia	Zia
zia-x-mawainage	Mawai Nage
zib	Zimbabwe Sign Language
zik	Zimakani
zil	Zialo
zim	Mesme
zin	Zinza
zir	Ziriya
ziw	Zigula
ziz	Zizilivakan
zka	Kaimbulawa
zkb	Koibal
zkd	Kadu
zkg	Koguryo
zkh	Khorezmian
zkk	Karankawa
zkn	Kanan
zko	Kott
zkr	Zakhring
zkt	Kitan
zku	Kaurna
zkv	Krevinian
zkz	Khazar
zlj	柳江
zlm	Malay (individual language)
zlm-x-akit	Akit
zlm-x-asahan	Asahan
zlm-x-batubara	Asahan Batubara
zlm-x-dataymalay	Datay Malay
zlm-x-deli	Deli
zlm-x-kapuashulu	Dayak Kapuas Hulu
zlm-x-kendawangan	Melayu Kendawangan
zlm-x-kisaran	Asahan Kisaran
zlm-x-melaypesisir	Melayu Pesisir
zlm-x-melayusambas	Melayu Sambas
zlm-x-perimping	Dayak Perimping
zlm-x-pontianak	Melayu Pontianak
zlm-x-sakai	Sakai
zlm-x-sandai	Melayu Sandai
zlm-x-sintang	Kentungau Sintang
zlm-x-talangmama	Talang Mamak
zlm-x-tanjngbalai	Asahan Tanjung Balai
zlm-x-tiong	Tionghoa Kwek
zln	连山
zlq	柳黔壯語
zma	Manda (Australia)
zmb	Zimba
zmb-x-kwange	Kwange
zmb-x-mamba	Mamba
zmd	Maridan
zmf	Mfinu
zmg	Marti Ke
zmi	Negeri Sembilan Malay
zmj	Maridjabin
zml	Madngele
zmm	Marimanindji
zmn	Mbangwe
zmo	Molo
zmp	Mpuono
zmq	Mituku
zmr	Maranunggu
zms	Mbesa
zmt	Maringarr
zmw	Mbo (Democratic Republic of Congo)
zmx	Bomitaba
zmy	Mariyedi
zmz	Mbandja
zna	Zan Gula
zne	Zande (individual language)
zng	Mang
zns	Mangas
zoc	Copainalá Zoque
zoh	Chimalapa Zoque
zom	Zou
zoo	Asunción Mixtepec Zapotec
zoq	Tabasco Zoque
zor	Rayón Zoque
zos	Francisco León Zoque
zpa	Lachiguiri Zapotec
zpb	Yautepec Zapotec
zpc	Choapan Zapotec
zpd	Southeastern Ixtlán Zapotec
zpe	Petapa Zapotec
zpf	San Pedro Quiatoni Zapotec
zpg	Guevea De Humboldt Zapotec
zph	Totomachapan Zapotec
zpi	Santa María Quiegolani Zapotec
zpj	Quiavicuzas Zapotec
zpk	Tlacolulita Zapotec
zpl	Lachixío Zapotec
zpm	Mixtepec Zapotec
zpn	Santa Inés Yatzechi Zapotec
zpo	Amatlán Zapotec
zpp	El Alto Zapotec
zpq	Zoogocho Zapotec
zpr	Santiago Xanica Zapotec
zps	Coatlán Zapotec
zpt	San Vicente Coatlán Zapotec
zpu	Yalálag Zapotec
zpv	Chichicapan Zapotec
zpw	Zaniza Zapotec
zpx	San Baltazar Loxicha Zapotec
zpy	Mazaltepec Zapotec
zpz	Texmelucan Zapotec
zqe	丘北
zra	Kara (Korea)
zrg	Mirgan
zrn	Zerenkel
zro	Záparo
zrs	Mairasi
zsa	Sarasira
zsk	Kaskean
zsl	Zambian Sign Language
zsm	Standard Malay
zsr	Southern Rincon Zapotec
zsu	Sukurum
zte	Elotepec Zapotec
ztg	Xanaguía Zapotec
ztl	Lapaguía-Guivini Zapotec
ztm	San Agustín Mixtepec Zapotec
ztn	Santa Catarina Albarradas Zapotec
ztp	Loxicha Zapotec
ztq	Quioquitani-Quierí Zapotec
zts	Tilquiapan Zapotec
ztt	Tejalapan Zapotec
ztu	Güilá Zapotec
ztx	Zaachila Zapotec
zty	Yatee Zapotec
zu	isiZulu
zua	Zeem
zuh	Tokano
zuh-x-ifiyufa	Mando Ifiyufa
zum	کمزاری
zun	Zuni
zuy	Zumaya
zwa	Zay
zxx	No linguistic content
zyb	邕北
zyg	得靖
zyj	右江
zyn	邕南
zyp	Zyphe Chin
zza	Zaza
zzj	左江